<!--Saved by Quest 5.0.4239.31339-->
<asl version="500">
  <implied element="object" property="alt" type="list" />
  <implied element="command" property="pattern" type="simplepattern" />
  <implied element="command" property="script" type="script" />
  <implied element="command" property="multiple" type="AssociatedScope" />
  <implied element="object" property="displayverbs" type="list" />
  <implied element="object" property="inventoryverbs" type="list" />
  <implied element="walkthrough" property="steps" type="list" />
  <implied element="timer" property="interval" type="int" />
  <implied element="timer" property="script" type="script" />
  <implied element="turnscript" property="script" type="script" />
  <template name="UnresolvedObject">I can't see that.</template>
  <template name="UnresolvedLocation">You can't go there.</template>
  <template name="DefaultObjectDescription">Nothing out of the ordinary.</template>
  <template name="DefaultSelfDescription">Looking good.</template>
  <template name="SeeListHeader">You can see</template>
  <template name="GoListHeader">You can go</template>
  <template name="And">and</template>
  <template name="Or">or</template>
  <template name="NothingToUndo">Nothing to undo!</template>
  <template name="NotCarryingAnything">You are not carrying anything.</template>
  <template name="CarryingListHeader">You are carrying</template>
  <template name="UnrecognisedCommand">I don't understand your command.</template>
  <template name="YouAreIn">You are in</template>
  <template name="LookAt">Look at</template>
  <template name="Take">Take</template>
  <template name="SpeakTo">Speak to</template>
  <template name="Use">Use</template>
  <template name="Drop">Drop</template>
  <template name="GoTo">Go to</template>
  <template name="Go">Go</template>
  <template name="SwitchOn">Switch on</template>
  <template name="SwitchOff">Switch off</template>
  <template name="Open">Open</template>
  <template name="Close">Close</template>
  <template name="NeutralGender">it</template>
  <template name="MaleGender">he</template>
  <template name="FemaleGender">she</template>
  <template name="SelfGender">you</template>
  <template name="NeutralPluralGender">they</template>
  <template name="MalePluralGender">they</template>
  <template name="FemalePluralGender">they</template>
  <template name="NeutralArticle">it</template>
  <template name="MaleArticle">him</template>
  <template name="FemaleArticle">her</template>
  <template name="SelfArticle">yourself</template>
  <template name="NeutralPluralArticle">them</template>
  <template name="MalePluralArticle">them</template>
  <template name="FemalePluralArticle">them</template>
  <template name="SelfAlias">me</template>
  <template name="SelfAlt">myself; self</template>
  <template name="AllObjects">all; everything</template>
  <template name="ParserIgnorePrefixes">the; a; an</template>
  <template name="CannotDoThat">You can't do that.</template>
  <template name="Done">Done.</template>
  <template name="ContainerContentsPrefix">containing</template>
  <template name="SurfaceContentsPrefix">on which there is</template>
  <template name="LockedExit">That way is locked.</template>
  <template name="NoKey">You do not have the key.</template>
  <template name="UnlockMessage">Unlocked.</template>
  <template name="LockMessage">Locked.</template>
  <template name="DefaultOops">There is nothing to correct.</template>
  <template name="CompassNW">northwest</template>
  <template name="CompassN">north</template>
  <template name="CompassNE">northeast</template>
  <template name="CompassW">west</template>
  <template name="CompassE">east</template>
  <template name="CompassSW">southwest</template>
  <template name="CompassS">south</template>
  <template name="CompassSE">southeast</template>
  <template name="CompassUp">up</template>
  <template name="CompassDown">down</template>
  <template name="CompassIn">in</template>
  <template name="CompassOut">out</template>
  <template name="CompassDirectionPrefix"></template>
  <template name="UpDownDirectionPrefix"></template>
  <template name="InOutDirectionPrefix"></template>
  <template name="CompassNWShort">nw</template>
  <template name="CompassNShort">n</template>
  <template name="CompassNEShort">ne</template>
  <template name="CompassWShort">w</template>
  <template name="CompassEShort">e</template>
  <template name="CompassSWShort">sw</template>
  <template name="CompassSShort">s</template>
  <template name="CompassSEShort">se</template>
  <template name="CompassUpShort">u</template>
  <template name="CompassDownShort">d</template>
  <template name="CompassInShort"></template>
  <template name="CompassOutShort">o</template>
  <template name="InventoryLabel">Inventory</template>
  <template name="PlacesObjectsLabel">Places and Objects</template>
  <template name="CompassLabel">Compass</template>
  <template name="InButtonLabel">in</template>
  <template name="OutButtonLabel">out</template>
  <template name="EmptyListLabel">(empty)</template>
  <template name="NothingSelectedLabel">(nothing selected)</template>
  <template name="go"><![CDATA[^go to (?<exit>.*)$|^go (?<exit>.*)$|^(?<exit>north|east|south|west|northeast|northwest|southeast|southwest|in|out|up|down|n|e|s|w|ne|nw|se|sw|o|u|d)$]]></template>
  <template name="lookdir"><![CDATA[^look (?<exit>north|east|south|west|northeast|northwest|southeast|southwest|out|up|down|n|e|s|w|ne|nw|se|sw|o|u|d)$]]></template>
  <template name="look">^look$</template>
  <template name="lookat">look at; x; examine; exam; ex; examinar; examina; ex; x</template>
  <template name="take">take; get; pick up; coger; coge; tomar; toma</template>
  <template name="undo">^undo$</template>
  <template name="inventory">^i$|^inv$|^inventory$</template>
  <template name="quit">^quit$</template>
  <template name="drop">drop; dejar; deja</template>
  <template name="use">use; usar; usa</template>
  <template name="speakto">speak to; speak; talk to; talk; hablar a; habla a; decir a; di a</template>
  <template name="open">open; abrir; abre</template>
  <template name="close">close; cerrar; cierra</template>
  <template name="put"><![CDATA[^put (?<object1>.*) (on|in) (?<object2>.*)$]]></template>
  <template name="removefrom"><![CDATA[^remove (?<object1>.*) from (?<object2>.*)$]]></template>
  <template name="ask"><![CDATA[^ask (?<object>.*) about (?<text>.*)$]]></template>
  <template name="tell"><![CDATA[^tell (?<object>.*) about (?<text>.*)$]]></template>
  <template name="oops"><![CDATA[^oops (?<text>.*)$]]></template>
  <template name="buy">buy; comprar</template>
  <template name="climb">climb; trepar</template>
  <template name="drink">drink; beber</template>
  <template name="eat">eat; comer</template>
  <template name="give"><![CDATA[^give (?<object1>.*) to (?<object2>.*)$]]></template>
  <template name="hit">hit; golpear;golpea</template>
  <template name="kill">kill; matar;mata</template>
  <template name="kiss">kiss; besar;besa</template>
  <template name="knock">knock; pegar;pega</template>
  <template name="lick">lick; chupar;chupa</template>
  <template name="lie">lie on; lie upon; lie down on; lie down upon; acostarse; echarse; descansar en; descansar sobre</template>
  <template name="listento">listen to; escuchar;escucha</template>
  <template name="lock">lock; bloquear;bloquea</template>
  <template name="move">move; mover;mueve</template>
  <template name="pull">pull; tirar de</template>
  <template name="push">push; empujar;empuja</template>
  <template name="read">read; leer;lee</template>
  <template name="search">search; buscar;busca</template>
  <template name="show">show; mostrar;muestra</template>
  <template name="sit">sit on; sit upon; sit down on; sit down upon; sit on; sit upon; sit down on; sit down upon</template>
  <template name="smell">smell; sniff; oler;huele</template>
  <template name="taste">taste; probar;prueba</template>
  <template name="throw">throw; lanzar;lanza</template>
  <template name="tie">tie; atar;ata</template>
  <template name="touch">touch; tocar;toca</template>
  <template name="turnon">turn on; turn #object# on; switch on; switch #object# on</template>
  <template name="turnoff">turn off; turn #object# off; switch off; switch #object# off</template>
  <template name="turn">turn; girar</template>
  <template name="unlock">unlock; desbloquear</template>
  <template name="untie">untie; desatar;desata</template>
  <template name="useon"><![CDATA[^use (?<object1>.*) on (?<object2>.*)$]]></template>
  <template name="wear">wear; llevar;lleva</template>
  <template name="listen">^listen$</template>
  <template name="DefaultListen">You can't hear much.</template>
  <template name="jump">^jump$</template>
  <template name="DefaultJump">You jump, but nothing happens.</template>
  <template name="sitdown">^sit$|^sit down$</template>
  <template name="DefaultSitDown">No time for lounging about now.</template>
  <template name="liedown">^lie$|^lie down$</template>
  <template name="DefaultLieDown">No time for lounging about now.</template>
  <template name="sleep">^sleep$|^rest$</template>
  <template name="DefaultSleep">No time for lounging about now.</template>
  <template name="wait">^wait$</template>
  <template name="DefaultWait">Time passes.</template>
  <template name="xyzzy">^xyzzy$</template>
  <template name="DefaultXyzzy">Surprisingly, absolutely nothing happens.</template>
  <template name="help">^help$|^\?$</template>
  <template name="DefaultHelp"><![CDATA[<u>Quick Help</u><br/><br/>
<b>- Objects:</b>  Try LOOK AT..., SPEAK TO..., TAKE..., DROP..., OPEN..., GIVE... TO..., USE... ON/WITH...<br/>
<b>- Inventory:</b>  See which items you are carrying by typing I, INV or INVENTORY.<br/>
<b>- Moving around:</b>  Press the compass buttons, or type GO NORTH, SOUTH, E, GO TO...<br/>
<b>- Shortcuts:</b>  Press the up arrow and down arrow to scroll through commands you have already typed in. Try X... as a shortcut for LOOK AT...]]></template>
  <template name="LanguageSpecificObjectTypes"></template>
  <template name="EditorVerbDefaultExpression">"You can't #verb# " + object.article + "."</template>
  <template name="UnresolvedObject">No ves eso.</template>
  <template name="UnresolvedLocation">No puedes ir por ahí.</template>
  <template name="DefaultObjectDescription">Nada fuera de lo común.</template>
  <template name="DefaultSelfDescription">Parece bueno.</template>
  <template name="SeeListHeader">Puedes ver</template>
  <template name="GoListHeader">Puedes ir</template>
  <template name="And">y</template>
  <template name="Or">o</template>
  <template name="NothingToUndo">¡¡¡ No se puede deshacer !!!</template>
  <template name="NotCarryingAnything">No llevas nada.</template>
  <template name="CarryingListHeader">Llevas</template>
  <template name="UnrecognisedCommand">No entiendo tu orden.</template>
  <template name="YouAreIn">Estás en</template>
  <template name="LookAt">Examinar</template>
  <template name="Take">Coger</template>
  <template name="SpeakTo">Decir a</template>
  <template name="Use">Usar</template>
  <template name="Drop">Dejar</template>
  <template name="GoTo">Ir a</template>
  <template name="Go">Ir</template>
  <template name="NeutralGender">lo</template>
  <template name="MaleGender">lo</template>
  <template name="FemaleGender">la</template>
  <template name="SelfGender">tu</template>
  <template name="NeutralArticle">el</template>
  <template name="MaleArticle">el</template>
  <template name="FemaleArticle">la</template>
  <template name="SelfArticle">tu mismo</template>
  <template name="AllObjects">todo; todos</template>
  <template name="ParserIgnorePrefixes">el; la; un; una; unos; al; a la</template>
  <template name="CannotDoThat">No puedes hacer eso.</template>
  <template name="Done">Hecho.</template>
  <template name="ContainerContentsPrefix">conteniendo</template>
  <template name="SurfaceContentsPrefix">y dentro hay</template>
  <template name="LockedExit">Esa dirección está bloqueada.</template>
  <template name="CompassNW">noroeste</template>
  <template name="CompassN">norte</template>
  <template name="CompassNE">noreste</template>
  <template name="CompassW">oeste</template>
  <template name="CompassOut">fuera</template>
  <template name="CompassE">este</template>
  <template name="CompassSW">suroeste</template>
  <template name="CompassS">sur</template>
  <template name="CompassSE">sureste</template>
  <template name="CompassUp">arriba</template>
  <template name="CompassDown">abajo</template>
  <template name="CompassDirectionPrefix">al</template>
  <template name="UpDownDirectionPrefix"></template>
  <template name="InOutDirectionPrefix"></template>
  <template name="CompassNWShort">no</template>
  <template name="CompassNShort">n</template>
  <template name="CompassNEShort">ne</template>
  <template name="CompassWShort">o</template>
  <template name="CompassEShort">e</template>
  <template name="CompassSWShort">so</template>
  <template name="CompassSShort">s</template>
  <template name="CompassSEShort">se</template>
  <template name="CompassUpShort">up</template>
  <template name="CompassDownShort">down</template>
  <template name="CompassInShort">in</template>
  <template name="CompassOutShort">out</template>
  <template name="InventoryLabel">Inventario</template>
  <template name="PlacesObjectsLabel">Lugares y Objetos</template>
  <template name="CompassLabel">Brújula</template>
  <template name="InButtonLabel">Entrar</template>
  <template name="OutButtonLabel">Salir</template>
  <template name="EmptyListLabel">(vacío)</template>
  <template name="NothingSelectedLabel">(nada seleccionado)</template>
  <template name="go"><![CDATA[^go to (?<exit>.*)$|^ir (?<exit>.*)$|^(?<exit>norte|este|sur|oeste|noreste|noroeste|sureste|suroeste|salir|arriba|abajo|n|e|s|o|ne|no|se|so|sal|sube|baja)$]]></template>
  <template name="lookdir"><![CDATA[^look (?<exit>north|east|south|west|northeast|northwest|southeast|southwest|out|up|down|n|e|s|w|ne|nw|se|sw|o|u|d)$]]></template>
  <template name="look">^(mirar|mira|m)$</template>
  <template name="undo">^deshacer$</template>
  <template name="inventory">^i$|^inv$|^inventario$</template>
  <template name="quit">^terminar$</template>
  <template name="put"><![CDATA[^(pon|poner|mete|meter|introduce|introducir) (?<object1>.*) (en|dentro|dentro de) (?<object2>.*)$]]></template>
  <template name="removefrom"><![CDATA[^(sacar|saca|coger|coge|extraer|extrae) (?<object1>.*) (de|desde) (?<object2>.*)$]]></template>
  <template name="ask"><![CDATA[^(preguntar|pregunta|pregúntale|preguntale) (?<object>.*) (sobre|acerca de| |) (?<text>.*)$]]></template>
  <template name="tell"><![CDATA[^(decir|di|dile) (?<object>.*) (?<text>.*)$]]></template>
  <template name="oops"><![CDATA[^oops (?<text>.*)$]]></template>
  <template name="give"><![CDATA[^(give|dar|da|entregar|entrega|dale|darle) (?<object1>.*) (to|a|al|) (?<object2>.*)$]]></template>
  <template name="turnon"><![CDATA[^turn on (?<object>.*)$|^turn (?<object>.*) on$|^switch on (?<object>.*)$|^switch (?<object>.*) on$]]></template>
  <template name="turnoff"><![CDATA[^turn off (?<object>.*)$|^turn (?<object>.*) off$|^switch off (?<object>.*)$|^switch (?<object>.*) off$]]></template>
  <template name="useon"><![CDATA[(^usa|^usar) (?<object1>.*) en (?<object2>.*)$]]></template>
  <template name="listen">(^listen$|^escuchar$|^escucha$|^oir$|^oye$)</template>
  <template name="DefaultListen">No escuchas nada que te llame la atención.</template>
  <template name="jump">^saltar$|^salta$</template>
  <template name="DefaultJump">Saltas, pero no ocurre nada.</template>
  <template name="sitdown">^sit$|^sit down$</template>
  <template name="DefaultSitDown">No time for lounging about now.</template>
  <template name="liedown">^lie$|^lie down$</template>
  <template name="DefaultLieDown">No time for lounging about now.</template>
  <template name="sleep">^sleep$|^rest$</template>
  <template name="DefaultSleep">No time for lounging about now.</template>
  <template name="wait">(^wait$|^esperar$|^espera$)</template>
  <template name="DefaultWait">El tiempo pasa.</template>
  <template name="xyzzy">^xyzzy$</template>
  <template name="DefaultXyzzy">Sorprendentemente, absolutamente nada ocurre.</template>
  <template name="help">^ayuda$|^\?$</template>
  <template name="DefaultHelp"><![CDATA[<u>Ayuda Rápida</u><br/><br/>
<b>- Objetos:</b>  Intenta EXAMINAR..., DECIR PERSONAJE ALGO..., COGER..., DEJAR..., ABRIR..., DAR... A..., USAR... EN...<br/>
<b>- Inventario:</b>  Para ver que objetos llevas, teclea I, INV or INVENTARIO.<br/>
<b>- Pistas:</b> Si estás muy atascad@, teclea PISTAS. Te ayudarán a resolver el puzzle...(o eso creo).<br/>
<b>- Moverte por el juego:</b>  Pulsa los botones de la brújula, o teclea, NORTE, SUR, E ...<br/>
<b>- Atajos:</b>  Pulsa las teclas arriba y abajo para que aparezcan los comandos que ya has tecleado anteriormente. Prueba X... como atajo para EXAMINAR, M para volver a mirar la localidad actual.<br/>
<b>- Aclaración:</b> Quest 5, a fecha de hoy 08/08/2011 está en fase beta. Si el parser te parece demasiado sordo, no es culpa del programa, sino del programador, en este caso Jhames. De modo que te animo a que me envíes sugerencias de mejora en el foro www.caad.es. Quest 5.0 está naciendo, y aún no posee las potentes librerías de otros parsers, pero si eres escritor de aventuras te animo a que colabores para incrementar su número, y así beneficiarnos todos. <br/>]]></template>
  <dynamictemplate name="TakeSuccessful">Capfirst(object.gender) + " coges."</dynamictemplate>
  <dynamictemplate name="TakeUnsuccessful">"No puedes coger" + object.gender + "."</dynamictemplate>
  <dynamictemplate name="DropSuccessful">Capfirst(object.gender) + " dejas."</dynamictemplate>
  <dynamictemplate name="DropUnsuccessful">"No puedes dejar" + object.gender + "."</dynamictemplate>
  <dynamictemplate name="AlreadyTaken">"Ya " + object.gender + " llevas."</dynamictemplate>
  <dynamictemplate name="NotCarrying">"No " + object.gender + " llevas."</dynamictemplate>
  <dynamictemplate name="CantUse">"No puedes usar" + object.gender + "."</dynamictemplate>
  <dynamictemplate name="DefaultSpeakTo">CapFirst(object.article) + " " + object.name + " no dice nada."</dynamictemplate>
  <dynamictemplate name="ObjectNotOpen">"Ese objeto no está abierto."</dynamictemplate>
  <dynamictemplate name="AlreadyOpen">CapFirst(object.article) + " " + object.name + " ya está abierto."</dynamictemplate>
  <dynamictemplate name="AlreadyClosed">CapFirst(object.article) + " " + object.name + " ya está cerrado."</dynamictemplate>
  <dynamictemplate name="CantOpen">"No puedes abrir" + object.gender + "."</dynamictemplate>
  <dynamictemplate name="CantClose">"No puedes cerrar" + object.gender + "."</dynamictemplate>
  <dynamictemplate name="OpenSuccessful">CapFirst(object.gender)  + " abres."</dynamictemplate>
  <dynamictemplate name="CloseSuccessful">CapFirst(object.gender)  + " cierras."</dynamictemplate>
  <dynamictemplate name="AlreadyThere">CapFirst(object.gender) + " ya está ahí."</dynamictemplate>
  <dynamictemplate name="ObjectContains">WriteVerb(object, "contain")</dynamictemplate>
  <dynamictemplate name="ContainerFull">CapFirst(object.gender) + " " + object.name + " está lleno."</dynamictemplate>
  <dynamictemplate name="DisambiguateMenu">"Por favor elige que '" + text + "' quieres decir:"</dynamictemplate>
  <dynamictemplate name="UndoTurn">"Deshecho: " + text</dynamictemplate>
  <dynamictemplate name="DefaultAsk">"Hablas, pero tus palabras solo las escucha el viento."</dynamictemplate>
  <dynamictemplate name="DefaultTell">"Hablas, pero tus palabras solo las escucha el viento."</dynamictemplate>
  <dynamictemplate name="LockedObject">WriteVerb(object, "be") + " locked."</dynamictemplate>
  <dynamictemplate name="AlreadyLocked">WriteVerb(object, "be") + " already locked."</dynamictemplate>
  <dynamictemplate name="AlreadyUnlocked">WriteVerb(object, "be") + " already unlocked."</dynamictemplate>
  <dynamictemplate name="CannotLockOpen">"You cannot lock " + object.article + " when " + object.gender + " " + Conjugate(object, "be") + " open."</dynamictemplate>
  <dynamictemplate name="AlreadySwitchedOn">WriteVerb(object, "be") + " already switched on."</dynamictemplate>
  <dynamictemplate name="AlreadySwitchedOff">WriteVerb(object, "be") + " already switched off."</dynamictemplate>
  <dynamictemplate name="SwitchedOn">"You switch " + object.article + " on."</dynamictemplate>
  <dynamictemplate name="SwitchedOff">"You switch " + object.article + " off."</dynamictemplate>
  <dynamictemplate name="ObjectDoesNotContain">CapFirst(GetDisplayAlias(object1)) + " " + Conjugate(object1, "do") + " not contain " + GetDisplayAlias(object2) + "."</dynamictemplate>
  <dynamictemplate name="YouLooking">"You are looking " + text +"."</dynamictemplate>
  <dynamictemplate name="DefaultBuy">"No puedes comprar" + object.gender + "."</dynamictemplate>
  <dynamictemplate name="DefaultClimb">"No puedes trepar" + object.gender + "."</dynamictemplate>
  <dynamictemplate name="DefaultDrink">"No puedes beberte" + object.gender + "."</dynamictemplate>
  <dynamictemplate name="DefaultEat">"No puedes comerte" + object.gender + "."</dynamictemplate>
  <dynamictemplate name="DefaultGive">CapFirst(object1.gender) + " " + object1.name + " no tiene ningún interés en " + object2.article + " " +  object2.name+"."</dynamictemplate>
  <dynamictemplate name="DefaultHit">"No puedes golpear" + object.gender + "."</dynamictemplate>
  <dynamictemplate name="DefaultKill">"No puedes matar" + object.gender + "."</dynamictemplate>
  <dynamictemplate name="DefaultKiss">"No puedes besar" + object.gender + "."</dynamictemplate>
  <dynamictemplate name="DefaultKnock">"No puedes pegar" + object.gender + "."</dynamictemplate>
  <dynamictemplate name="DefaultLick">"No puedes chupar" + object.gender + "."</dynamictemplate>
  <dynamictemplate name="DefaultLie">"No puedes echarte  ahí."</dynamictemplate>
  <dynamictemplate name="DefaultListenTo">"Escuchas, pero no oyes ningún sonido."</dynamictemplate>
  <dynamictemplate name="DefaultLock">"No puedes bloquear" + object.gender + "."</dynamictemplate>
  <dynamictemplate name="DefaultMove">"No puedes mover" + object.gender + "."</dynamictemplate>
  <dynamictemplate name="DefaultPull">"No puedes tirar de eso."</dynamictemplate>
  <dynamictemplate name="DefaultPush">"No puedes empujar" + object.gender + "."</dynamictemplate>
  <dynamictemplate name="DefaultRead">"No puedes leer" + object.gender + "."</dynamictemplate>
  <dynamictemplate name="DefaultSearch">"No puedes buscar" + object.gender + "."</dynamictemplate>
  <dynamictemplate name="DefaultShow">"No puedes mostrar" + object.gender + "."</dynamictemplate>
  <dynamictemplate name="DefaultSit">"No puedes sentarte en eso."</dynamictemplate>
  <dynamictemplate name="DefaultSmell">"Hueles, pero no notas que huela a nada en particular."</dynamictemplate>
  <dynamictemplate name="DefaultTaste">"No puedes probar" + object.gender + "."</dynamictemplate>
  <dynamictemplate name="DefaultThrow">"No puedes lanzar" + object.gender + "."</dynamictemplate>
  <dynamictemplate name="DefaultTie">"No puedes atar" + object.gender + "."</dynamictemplate>
  <dynamictemplate name="DefaultTouch">"No te apetece tocar" + object.gender + " ahora."</dynamictemplate>
  <dynamictemplate name="DefaultTurnOn">"No puedes encender" + object.article</dynamictemplate>
  <dynamictemplate name="DefaultTurnOff">"No puedes apagar" + object.gender</dynamictemplate>
  <dynamictemplate name="DefaultTurn">"No puedes girar" + object.gender </dynamictemplate>
  <dynamictemplate name="DefaultUnlock">"No puedes desbloquear" + object.gender + "."</dynamictemplate>
  <dynamictemplate name="DefaultUntie">"No puedes desatar" + object.gender + "."</dynamictemplate>
  <dynamictemplate name="DefaultUseOn">"No puedes usar" + object2.gender + " de ese modo."</dynamictemplate>
  <dynamictemplate name="DefaultWear">"No puedes llevar" + object.gender + "."</dynamictemplate>
  <delegate name="AddScript" parameters="object" type="" />
  <delegate name="AssociatedScope" parameters="" type="objectlist" />
  <game name="Nearco II (Remake) - La perdición de la Ninfa - Vr Offline">
    <version>Vr. 2.0</version>
    <author>Jhames</author>
    <useframe />
    <defaultfontsize type="int">12</defaultfontsize>
    <enablehyperlinks />
    <defaultlinkforeground>OrangeRed</defaultlinkforeground>
    <showpanes type="boolean">false</showpanes>
    <start type="script"><![CDATA[
      SetFramePicture ("nearco.jpg")
      play sound ("nearco.mp3", false, false)
      SetFontSize (12)
      SetForegroundColour ("Blue")
      PrintCentered ("<br/>NEARCO II (REMAKE) - \"LA PERDICIÓN DE LA NINFA\"<br/>Autor: Jhames. Año: 2011<br/>Contacto: Bolumbero@hotmail.com<br/>")
      msg ("Pulsa una tecla...")
      WaitForKeyPress
      ClearScreen
      msg ("<br/>Tu nombre es Nearco. <br/><br/>Tu señor, Alejandro Magno te ha enviado a estas tierras para buscar un valioso tesoro guardado con sumo celo por el gran rey persa el Codomano.<br/><br/>En la primera parte de tus aventuras tuviste que atravesar las cuevas de Evil-Merodak, que fueron posteriormente ampliadas por el poderoro monarca del imperio persa, Darío III. <br/><br/>Según el oráculo de Delfos, cuando atravesases dichas cuevas podrías continuar con tu búsqueda.<br/><br/>Después de descender por un tobogán de piedra, te encontraste con el dios RAR que te hizo una pregunta a la que respondiste con la palabra: CODOMANO. Después de eso, continuáste cayendo hasta que la esponjosa arena amortiguó tu brusca caída, donde aterrizaste con tu valiosa cabecita...<br/><br/>")
      WaitForKeyPress
      msg ("Pulsa una tecla...")
      ClearScreen
      SetForegroundColour ("Black")
      msg ("<br/>Para parar la música teclea: MUSICA OFF<br/>Para escuchar la música teclea: MUSICA ON<br/>Para obtener AYUDA, teclea AYUDA<br/>Si te encuentras muy atascado, teclea PISTAS<br/>Para volver al estado anterior de un comando, teclea DESHACER<br/>Para hablar con personajes, utiliza la fórmula: DECIR PERSONAJE TAL o DI PERSONAJE TAL (Ej. Di Viejo zanahoria)<br/>Para Invidentes: Existen algunos gráficos esenciales para la terminación de la aventura. Si quieres una descripción más detallada del gráfico teclea XI OBJETO (X=Examina I=Invidente).<br/><br/>(En cualquier caso los efectos sonoros seguirán funcionando. Si no quieres escucharlos, desactiva el volumen te tu equipo).")
      WaitForKeyPress
      msg ("Pulsa una tecla...")
      ClearScreen
    ]]></start>
  </game>
  <command name="lookat">
    <pattern>look at #object#; x #object#; examine #object#; exam #object#; ex #object#; examinar #object#; examina #object#; ex #object#; x #object#</pattern>
    <script>
      if (GetBoolean(object, "hidechildren")) {
        object.hidechildren = false
      }
      if (TypeOf(object, "look") = "script") {
        do (object, "look")
      }
      else {
        lookdesc = ""
        if (HasString(object, "look")) {
          lookdesc = object.look
        }
        if (LengthOf(lookdesc) = 0) {
          lookdesc = Template("DefaultObjectDescription")
        }
        if (GetBoolean(object, "switchedon")) {
          if (HasString(object, "switchedondesc")) {
            lookdesc = lookdesc + " " + object.switchedondesc
          }
        }
        else {
          if (HasString(object, "switchedoffdesc")) {
            lookdesc = lookdesc + " " + object.switchedoffdesc
          }
        }
        msg (lookdesc)
      }
      ListObjectContents (object)
    </script>
  </command>
  <command name="take">
    <pattern>take #object#; get #object#; pick up #object#; coger #object#; coge #object#; tomar #object#; toma #object#</pattern>
    <multiple>
      return (ScopeVisibleNotHeld() - player)
    </multiple>
    <script>
      foreach (obj, object) {
        DoTake (obj, multiple)
      }
    </script>
  </command>
  <command name="drop">
    <pattern>drop #object#; dejar #object#; deja #object#</pattern>
    <multiple>
      return (ScopeInventory())
    </multiple>
    <script>
      foreach (obj, object) {
        DoDrop (obj, multiple)
      }
    </script>
  </command>
  <command name="use">
    <pattern>use #object#; usar #object#; usa #object#</pattern>
    <script>
      if (HasScript(object, "use")) {
        do (object, "use")
      }
      else {
        msg (DynamicTemplate("CantUse", object))
      }
    </script>
  </command>
  <command name="undo">
    <pattern type="string">^deshacer$</pattern>
    <isundo />
    <script>
      undo
    </script>
  </command>
  <command name="inventory">
    <pattern type="string">^i$|^inv$|^inventario$</pattern>
    <script>
      list = FormatObjectList(Template("CarryingListHeader"), player, Template("And"), ".", true)
      if (list = "") {
        msg (Template("NotCarryingAnything"))
      }
      else {
        msg (list)
      }
    </script>
  </command>
  <command name="look">
    <pattern type="string">^(mirar|mira|m)$</pattern>
    <script>
      ShowRoomDescription
    </script>
  </command>
  <command name="lookdir">
    <pattern type="string"><![CDATA[^look (?<exit>north|east|south|west|northeast|northwest|southeast|southwest|out|up|down|n|e|s|w|ne|nw|se|sw|o|u|d)$]]></pattern>
    <script><![CDATA[
      if (HasScript(exit, "look")) {
        do (exit, "look")
      }
      else {
        message = DynamicTemplate("YouLooking",exit.alias)
        if (HasString(exit, "look")) {
          if (exit.look <> "") {
            message = exit.look
          }
        }
        if (exit.locked) {
          if (HasString(exit,"lockmessage")) {
            lockmessage = exit.lockmessage
          }
          else {
            lockmessage = Template("LockedExit")
          }
          msg (message+" "+lockmessage)
        }
        else {
          msg (message)
        }
      }
    ]]></script>
  </command>
  <command name="quit">
    <pattern type="string">^terminar$</pattern>
    <script>
      request (Quit, "")
    </script>
  </command>
  <command name="go">
    <pattern type="string"><![CDATA[^go to (?<exit>.*)$|^ir (?<exit>.*)$|^(?<exit>norte|este|sur|oeste|noreste|noroeste|sureste|suroeste|salir|arriba|abajo|n|e|s|o|ne|no|se|so|sal|sube|baja)$]]></pattern>
    <unresolved>No puedes ir por ahí.</unresolved>
    <script>
      if (exit.locked) {
        msg (exit.lockmessage)
      }
      else if (HasScript(exit, "script")) {
        do (exit, "script")
      }
      else {
        if (exit.lookonly) {
          msg ("No puedes ir por ahí.")
        }
        else {
          player.parent = exit.to
        }
      }
    </script>
  </command>
  <command name="open">
    <pattern>open #object#; abrir #object#; abre #object#</pattern>
    <script>
      TryOpenClose (true, object)
    </script>
  </command>
  <command name="close">
    <pattern>close #object#; cerrar #object#; cierra #object#</pattern>
    <script>
      TryOpenClose (false, object)
    </script>
  </command>
  <command name="put">
    <pattern type="string"><![CDATA[^(pon|poner|mete|meter|introduce|introducir) (?<object1>.*) (en|dentro|dentro de) (?<object2>.*)$]]></pattern>
    <script>
      if (object1.parent = object2) {
        msg (DynamicTemplate("AlreadyThere", object1))
      }
      else if (not ListContains(ScopeInventory(), object1)) {
        msg (DynamicTemplate("NotCarrying", object1))
      }
      else if (not ListContains(ScopeReachable(), object1)) {
        msg (DynamicTemplate("ObjectNotOpen", GetBlockingObject(object1)))
      }
      else if (not ListContains(ScopeReachable(), object2)) {
        msg (DynamicTemplate("ObjectNotOpen", GetBlockingObject(object2)))
      }
      else if (not object2.container) {
        msg (Template("CannotDoThat"))
      }
      else if (not object2.isopen) {
        msg (DynamicTemplate("ObjectNotOpen", object2))
      }
      else {
        if (GetBoolean(object2, "hidechildren")) {
          object2.hidechildren = false
        }
        if (HasDelegateImplementation(object2, "addscript")) {
          rundelegate (object2, "addscript", object1)
        }
        else {
          object1.parent = object2
          msg (Template("Done"))
        }
      }
    </script>
  </command>
  <command name="removefrom">
    <pattern type="string"><![CDATA[^(sacar|saca|coger|coge|extraer|extrae) (?<object1>.*) (de|desde) (?<object2>.*)$]]></pattern>
    <script>
      if (not Contains(object2, object1)) {
        msg (DynamicTemplate("ObjectDoesNotContain", object2, object1))
      }
      else {
        DoTake (object1, false)
      }
    </script>
  </command>
  <command name="give">
    <pattern type="string"><![CDATA[^(give|dar|da|entregar|entrega|dale|darle) (?<object1>.*) (to|a|al|) (?<object2>.*)$]]></pattern>
    <script>
      handled = false
      if (HasString(object2, "give")) {
        msg (object2.give)
        handled = true
      }
      else if (typeof(object2, "give") = "scriptdictionary") {
        if (DictionaryContains(object2.give, object1.name)) {
          invoke (ScriptDictionaryItem(object2.give, object1.name))
          handled = true
        }
      }
      if (not handled) {
        msg (DynamicTemplate("DefaultGive", object2, object1))
      }
    </script>
  </command>
  <command name="useon">
    <pattern type="string"><![CDATA[(^usa|^usar) (?<object1>.*) en (?<object2>.*)$]]></pattern>
    <script>
      handled = false
      if (HasString(object2, "useon")) {
        msg (object2.useon)
        handled = true
      }
      else if (typeof(object2, "useon") = "scriptdictionary") {
        if (DictionaryContains(object2.useon, object1.name)) {
          invoke (ScriptDictionaryItem(object2.useon, object1.name))
          handled = true
        }
      }
      if (not handled) {
        msg (DynamicTemplate("DefaultUseOn", object2, object1))
      }
    </script>
  </command>
  <command name="ask">
    <pattern type="string"><![CDATA[^(preguntar|pregunta|pregúntale|preguntale) (?<object>.*) (sobre|acerca de| |) (?<text>.*)$]]></pattern>
    <script>
      DoAskTell (object, text, "ask", "askdefault", "DefaultAsk")
    </script>
  </command>
  <command name="tell">
    <pattern type="string"><![CDATA[^(decir|di|dile) (?<object>.*) (?<text>.*)$]]></pattern>
    <script>
      DoAskTell (object, text, "tell", "telldefault", "DefaultTell")
    </script>
  </command>
  <command name="oops">
    <pattern type="string"><![CDATA[^oops (?<text>.*)$]]></pattern>
    <isoops />
    <script><![CDATA[
      hasoops = false
      if (HasAttribute(game, "unresolvedcommand")) {
        if (game.unresolvedcommand <> null) {
          hasoops = true
        }
      }
      if (not hasoops) {
        msg (Template("DefaultOops"))
      }
      else {
        dictionary remove (game.unresolvedcommandvarlist, game.unresolvedcommandkey)
        dictionary add (game.unresolvedcommandvarlist, game.unresolvedcommandkey, text)
        HandleSingleCommandPattern ("", game.unresolvedcommand, game.unresolvedcommandvarlist)
      }
    ]]></script>
  </command>
  <verb name="speak">
    <pattern>speak to #object#; speak #object#; talk to #object#; talk #object#; hablar a #object#; habla a #object#; decir a #object#; di a #object#</pattern>
    <property>speak</property>
    <defaulttemplate>DefaultSpeakTo</defaulttemplate>
  </verb>
  <verb name="buy">
    <pattern>buy #object#; comprar #object#</pattern>
    <property>buy</property>
    <defaulttemplate>DefaultBuy</defaulttemplate>
  </verb>
  <verb name="climb">
    <pattern>climb #object#; trepar #object#</pattern>
    <property>climb</property>
    <defaulttemplate>DefaultClimb</defaulttemplate>
  </verb>
  <verb name="drink">
    <pattern>drink #object#; beber #object#</pattern>
    <property>drink</property>
    <defaulttemplate>DefaultDrink</defaulttemplate>
  </verb>
  <verb name="eat">
    <pattern>eat #object#; comer #object#</pattern>
    <property>eat</property>
    <defaulttemplate>DefaultEat</defaulttemplate>
  </verb>
  <verb name="hit">
    <pattern>hit #object#; golpear #object#; golpea #object#</pattern>
    <property>hit</property>
    <defaulttemplate>DefaultHit</defaulttemplate>
  </verb>
  <verb name="kill">
    <pattern>kill #object#; matar #object#; mata #object#</pattern>
    <property>kill</property>
    <defaulttemplate>DefaultKill</defaulttemplate>
  </verb>
  <verb name="kiss">
    <pattern>kiss #object#; besar #object#; besa #object#</pattern>
    <property>kiss</property>
    <defaulttemplate>DefaultKiss</defaulttemplate>
  </verb>
  <verb name="knock">
    <pattern>knock #object#; pegar #object#; pega #object#</pattern>
    <property>knock</property>
    <defaulttemplate>DefaultKnock</defaulttemplate>
  </verb>
  <verb name="lick">
    <pattern>lick #object#; chupar #object#; chupa #object#</pattern>
    <property>lick</property>
    <defaulttemplate>DefaultLick</defaulttemplate>
  </verb>
  <verb name="lieon">
    <pattern>lie on #object#; lie upon #object#; lie down on #object#; lie down upon #object#; acostarse #object#; echarse #object#; descansar en #object#; descansar sobre #object#</pattern>
    <property>lie</property>
    <defaulttemplate>DefaultLie</defaulttemplate>
  </verb>
  <verb name="listento">
    <pattern>listen to #object#; escuchar #object#; escucha #object#</pattern>
    <property>listen</property>
    <defaulttemplate>DefaultListenTo</defaulttemplate>
  </verb>
  <verb name="lock">
    <pattern>lock #object#; bloquear #object#; bloquea #object#</pattern>
    <property>lock</property>
    <defaulttemplate>DefaultLock</defaulttemplate>
  </verb>
  <verb name="move">
    <pattern>move #object#; mover #object#; mueve #object#</pattern>
    <property>move</property>
    <defaulttemplate>DefaultMove</defaulttemplate>
  </verb>
  <verb name="pull">
    <pattern>pull #object#; tirar de #object#</pattern>
    <property>pull</property>
    <defaulttemplate>DefaultPull</defaulttemplate>
  </verb>
  <verb name="push">
    <pattern>push #object#; empujar #object#; empuja #object#</pattern>
    <property>push</property>
    <defaulttemplate>DefaultPush</defaulttemplate>
  </verb>
  <verb name="read">
    <pattern>read #object#; leer #object#; lee #object#</pattern>
    <property>read</property>
    <defaulttemplate>DefaultRead</defaulttemplate>
  </verb>
  <verb name="search">
    <pattern>search #object#; buscar #object#; busca #object#</pattern>
    <property>search</property>
    <defaulttemplate>DefaultSearch</defaulttemplate>
  </verb>
  <verb name="siton">
    <pattern>sit on #object#; sit upon #object#; sit down on #object#; sit down upon #object#; sit on #object#; sit upon #object#; sit down on #object#; sit down upon #object#</pattern>
    <property>sit</property>
    <defaulttemplate>DefaultSit</defaulttemplate>
  </verb>
  <verb name="smell">
    <pattern>smell #object#; sniff #object#; oler #object#; huele #object#</pattern>
    <property>smell</property>
    <defaulttemplate>DefaultSmell</defaulttemplate>
  </verb>
  <verb name="taste">
    <pattern>taste #object#; probar #object#; prueba #object#</pattern>
    <property>taste</property>
    <defaulttemplate>DefaultTaste</defaulttemplate>
  </verb>
  <verb name="throw">
    <pattern>throw #object#; lanzar #object#; lanza #object#</pattern>
    <property>throw</property>
    <defaulttemplate>DefaultThrow</defaulttemplate>
  </verb>
  <verb name="tie">
    <pattern>tie #object#; atar #object#; ata #object#</pattern>
    <property>tie</property>
    <defaulttemplate>DefaultThrow</defaulttemplate>
  </verb>
  <verb name="touch">
    <pattern>touch #object#; tocar #object#; toca #object#</pattern>
    <property>touch</property>
    <defaulttemplate>DefaultTouch</defaulttemplate>
  </verb>
  <verb name="turnon">
    <pattern><![CDATA[^turn on (?<object>.*)$|^turn (?<object>.*) on$|^switch on (?<object>.*)$|^switch (?<object>.*) on$ #object#]]></pattern>
    <property>turnon</property>
    <defaulttemplate>DefaultTurnOn</defaulttemplate>
  </verb>
  <verb name="turnoff">
    <pattern><![CDATA[^turn off (?<object>.*)$|^turn (?<object>.*) off$|^switch off (?<object>.*)$|^switch (?<object>.*) off$ #object#]]></pattern>
    <property>turnoff</property>
    <defaulttemplate>DefaultTurnOff</defaulttemplate>
  </verb>
  <verb name="turn">
    <pattern>turn #object#; girar #object#</pattern>
    <property>turn</property>
    <defaulttemplate>DefaultTurn</defaulttemplate>
  </verb>
  <verb name="unlock">
    <pattern>unlock #object#; desbloquear #object#</pattern>
    <property>unlock</property>
    <defaulttemplate>DefaultUnlock</defaulttemplate>
  </verb>
  <verb name="untie">
    <pattern>untie #object#; desatar #object#; desata #object#</pattern>
    <property>untie</property>
    <defaulttemplate>DefaultUntie</defaulttemplate>
  </verb>
  <verb name="wear">
    <pattern>wear #object#; llevar #object#; lleva #object#</pattern>
    <property>wear</property>
    <defaulttemplate>DefaultWear</defaulttemplate>
  </verb>
  <command name="listen">
    <pattern type="string">(^listen$|^escuchar$|^escucha$|^oir$|^oye$)</pattern>
    <script>
      msg (Template("DefaultListen"))
    </script>
  </command>
  <command name="jump">
    <pattern type="string">^saltar$|^salta$</pattern>
    <script>
      msg (Template("DefaultJump"))
    </script>
  </command>
  <command name="sit">
    <pattern type="string">^sit$|^sit down$</pattern>
    <script>
      msg (Template("DefaultSitDown"))
    </script>
  </command>
  <command name="lie">
    <pattern type="string">^lie$|^lie down$</pattern>
    <script>
      msg (Template("DefaultLieDown"))
    </script>
  </command>
  <command name="sleep">
    <pattern type="string">^sleep$|^rest$</pattern>
    <script>
      msg (Template("DefaultSleep"))
    </script>
  </command>
  <command name="wait">
    <pattern type="string">(^wait$|^esperar$|^espera$)</pattern>
    <script>
      msg (Template("DefaultWait"))
    </script>
  </command>
  <command name="xyzzy">
    <pattern type="string">^xyzzy$</pattern>
    <script>
      msg (Template("DefaultXyzzy"))
    </script>
  </command>
  <command name="help">
    <pattern type="string">^ayuda$|^\?$</pattern>
    <script>
      msg (Template("DefaultHelp"))
    </script>
  </command>
  <object name="salida de la cueva">
    <alias>la salida de la cueva</alias>
    <usedefaultprefix type="boolean">false</usedefaultprefix>
    <prefix type="string"></prefix>
    <picture>SalidaCueva1.jpg</picture>
    <description type="string"></description>
    <firstenter type="script">
      msg ("Te has dado un terrible golpe en la cabeza. Te duele de un modo horrible, y no sabes muy bien dónde te encuentras. El suelo está lleno de arena. Has perdido la orientación, por lo que decides descansar unos minutos hasta recuperarte.")
    </firstenter>
    <object name="player">
      <inherit name="defaultplayer" />
      <alias>yo</alias>
      <alt>myself; self</alt>
      <object name="casco">
        <inherit name="container_open" />
        <take />
        <inventoryverbs>Examinar; Dejar</inventoryverbs>
        <open type="boolean">false</open>
        <close type="boolean">false</close>
        <hidechildren />
        <poner>Ok. Pero eso no te va a servir de nada.</poner>
        <displayverbs>Examinar; Coger</displayverbs>
        <usedefaultprefix type="boolean">false</usedefaultprefix>
        <alias>casco</alias>
        <prefix>un</prefix>
        <gender>lo</gender>
        <article>el</article>
        <look type="script">
          SetFramePicture ("casco.jpg")
          msg ("Es el casco griego que te ha acompañado en mil y una batallas. Brilla relucientemente cuando le dan los rayos del Sol, produciendo reflejos en todas direcciones. En la parte del mentón, lleva una correa (llamada barbuquejo) para sujetarlo firmemente a la cabeza, de modo que no se desplace con tus movimientos, durante los combates.")
        </look>
        <useon type="scriptdictionary">
          <item key="barbuquejo">
            msg ("El barbuquejo ya está atado dentro del casco.")
          </item>
          <item key="espada">
            msg ("Golpeas la espada contra el casco. Es lo que soléis hacer los soldados macedonios para infundiros ánimos antes de la batalla.")
          </item>
          <item key="Viejo">
            msg ("No. El casco está mejor en tu cabeza.")
          </item>
          <item key="numero">
            msg ("Frotas el pergamino contra el casco para limpiarle una motita de polvo persa. Ahora ha quedado reluciente.")
          </item>
        </useon>
        <object name="barbuquejo">
          <inventoryverbs>Examinar; Dejar</inventoryverbs>
          <scenery type="boolean">false</scenery>
          <look>Es una cinta que sirve para atarse el casco y que no se desplace durante las batallas. Aparte de eso, en este juego no tiene otra utilidad.</look>
          <desata>Nap. No vas a necesitar el barbujejo para nada en este juego.</desata>
          <desatar>Nap. No vas a necesitar el barbujejo para nada en este juego.</desatar>
          <takemsg>Está muy bien donde está. No necesitas coger el barbuquejo para nada.</takemsg>
          <drop type="boolean">false</drop>
          <dropmsg>Está muy bien donde está. No necesitas dejar el barbuquejo para nada.</dropmsg>
          <alias>barbuquejo</alias>
          <usedefaultprefix type="boolean">false</usedefaultprefix>
          <prefix>un</prefix>
          <touch>Le haces cosquillas con tus dedos, pero el barbuquejo, impasible, ni se inmuta.</touch>
          <abrir>No. Mejor déjalo como está. No lo vas a necesitar en este juego.</abrir>
          <empujar>No. Mejor déjalo como está. No lo vas a necesitar en este juego.</empujar>
          <lick>Hmmmm.. .delicioso. El sudor que lleva impregnado apaga tu sed durante unos segundos.</lick>
          <mover>No se puede mover. Está bien atado.</mover>
          <romper>Es una dura correa de cuero. Y además te es muy útil. Es mejor que no rompas el barbuquejo.</romper>
          <alt>correa; cinta</alt>
        </object>
      </object>
      <object name="espada">
        <gender>la</gender>
        <article>la</article>
        <take />
        <displayverbs>Examinar; Coger; Usar</displayverbs>
        <usedefaultprefix type="boolean">false</usedefaultprefix>
        <alias>espada</alias>
        <prefix>una</prefix>
        <look type="script">
          SetFramePicture ("espada.jpg")
          msg ("Es una espada muy afilada. En el mango lleva una inscripción. Su traducción aproximada podría ser: \"Cuanto más te hundas, más muerte traerás\".")
        </look>
        <use type="script">
          msg ("La agitas durante unos segundos en el aire, dando unos cuantos mandobles, y observas que está bien balanceada. Aparte de eso, no haces nada más.")
        </use>
        <useon type="scriptdictionary">
          <item key="casco">
            msg ("Golpeas el casco contra la espada. Es lo que soléis hacer para infundiros ánimos antes de la batalla.")
          </item>
          <item key="numero">
            msg ("Con el pergamino abrillantas la espada. Queda reluciente. Lista para la batalla.")
          </item>
        </useon>
      </object>
    </object>
    <exit alias="norte" to="crucecaminos">
      <inherit name="northdirection" />
      <inherit name="compassdirection" />
    </exit>
    <object name="cueva">
      <alt>caverna; gruta; salida</alt>
      <scenery />
      <look>Es una cueva muy pequeña. Aquí es donde has caído desde el tobogán de piedra que había en el palacio situado en la parte superior de la gruta.</look>
      <alias>cueva</alias>
      <gender>la</gender>
      <article>la</article>
    </object>
    <object name="arena">
      <scenery />
      <look>Arena. Fínisima, compuesta por miles de millones de trillones de granos.</look>
      <alt>suelo; tierra</alt>
      <alias>arena</alias>
      <gender>la</gender>
      <article>la</article>
    </object>
    <object name="granos">
      <scenery />
      <look>¡¡¡ No te pases !!! Como broma ya está bien.</look>
      <alt>grano</alt>
      <alias>granos</alias>
      <gender>los</gender>
      <article>los</article>
    </object>
    <object name="cabeza">
      <scenery />
      <look>Tu cabeza es dura como una roca. Aunque ahora te duele un poquito más que de costumbre, por el golpe.</look>
      <alias>cabeza</alias>
      <gender>la</gender>
      <article>la</article>
      <alt>golpe</alt>
    </object>
    <object name="inscripcion">
      <alt>inscripcion; rotulo; letrero; lema</alt>
      <scenery />
      <look>Algo escrito en griego que te recuerda que tienes que matar a todo bicho viviente que se te cruce por el camino.</look>
      <gender>la</gender>
      <article>la</article>
      <alias>inscripción</alias>
    </object>
    <object name="tobogan">
      <scenery />
      <alt>tobogan; palacio; piedra</alt>
      <look>Encima de tí hay un palacio persa desde el que has caído a esta salida, a través de un larguísimo tobogán de piedra.</look>
      <alias>tobogán</alias>
      <gender>lo</gender>
      <article>el</article>
    </object>
  </object>
  <verb name="Desatar">
    <property>desatar</property>
    <pattern>desatar;desata</pattern>
    <defaultexpression>"No puedes desatar eso."</defaultexpression>
  </verb>
  <object name="crucecaminos">
    <picture>Crucecaminos.jpg</picture>
    <usedefaultprefix type="boolean">false</usedefaultprefix>
    <prefix>un</prefix>
    <alias>cruce de caminos</alias>
    <description type="string"></description>
    <firstenter type="script"><![CDATA[
      msg ("Desde aquí ves como el camino se divide en tres sendas.<br/>Ahora debes elegir cuál vas a tomar. Solo los dioses conocen el camino correcto que has de seguir...")
    ]]></firstenter>
    <exit alias="sur" to="salida de la cueva">
      <inherit name="compassdirection" />
      <inherit name="southdirection" />
    </exit>
    <exit alias="noroeste" to="Camino Noroeste">
      <inherit name="northwestdirection" />
      <inherit name="compassdirection" />
    </exit>
    <exit alias="norte" to="Camino Norte">
      <inherit name="northdirection" />
      <inherit name="compassdirection" />
    </exit>
    <exit alias="noreste" to="Camino Noreste">
      <inherit name="northeastdirection" />
      <inherit name="compassdirection" />
    </exit>
    <object name="hierba1">
      <inherit name="female" />
      <gender>la</gender>
      <article>la</article>
      <usedefaultprefix type="boolean">false</usedefaultprefix>
      <scenery />
      <look>Simple hierba. Buena para los conejos.</look>
      <alias>hierba</alias>
      <cortar>No vas a necesitar la vegetación cortada para nada.</cortar>
    </object>
    <object name="camino">
      <scenery />
      <look>Desde aquí ves como el camino se divide en tres sendas.</look>
      <alt>senda; sendas; cruce</alt>
      <alias>camino</alias>
      <gender>lo</gender>
      <article>el</article>
    </object>
  </object>
  <object name="Camino Noreste">
    <description type="string"></description>
    <picture>caminonorete.jpg</picture>
    <usedefaultprefix type="boolean">false</usedefaultprefix>
    <alias>camino</alias>
    <prefix>un</prefix>
    <firstenter type="script">
      msg ("Únicamente Zeus sabe dónde te llevará este camino. Sin embargo confías en el filo de tu espada y sigues hacia adelante. ")
    </firstenter>
    <exit alias="suroeste" to="crucecaminos">
      <inherit name="compassdirection" />
      <inherit name="southwestdirection" />
    </exit>
    <exit alias="noreste" to="camino norestenoreste">
      <inherit name="compassdirection" />
      <inherit name="northeastdirection" />
    </exit>
    <object name="hierba4">
      <inherit name="female" />
      <gender>la</gender>
      <article>la</article>
      <usedefaultprefix type="boolean">false</usedefaultprefix>
      <scenery />
      <look>Simple hierba. Buena para los conejos.</look>
      <alias>hierba</alias>
      <cortar>No vas a necesitar la vegetación cortada para nada.</cortar>
    </object>
    <object name="camino3">
      <scenery />
      <look>Es un camino rodeado por vegetación. Seguro que te lleva a otro lugar...</look>
      <alias>camino</alias>
      <gender>lo</gender>
      <article>el</article>
    </object>
    <object name="vegetación">
      <alt>tomillo; romero; árboles; arboles; árbol; arbol; suelo; arena; vegetacion</alt>
      <scenery />
      <look>En esta localidad, ahora mismo nada de eso es relevante.</look>
      <alias>vegetación</alias>
      <gender>la</gender>
      <article>la</article>
      <cortar>No vas a necesitar la vegetación cortada para nada.</cortar>
    </object>
  </object>
  <object name="Camino Norte">
    <picture>camino norte.jpg</picture>
    <description type="string"></description>
    <usedefaultprefix type="boolean">false</usedefaultprefix>
    <alias>camino</alias>
    <prefix>un</prefix>
    <firstenter type="script">
      msg ("El olor de la vegetación impregna tus fosas nasales. La fragancia del tomillo y el romero te transporta a aquellos días en los que preparabas paellas de arroz con conejo, al estilo griego, a las tropas de Alejandro. ")
    </firstenter>
    <exit alias="sur" to="crucecaminos">
      <inherit name="compassdirection" />
      <inherit name="southdirection" />
    </exit>
    <exit alias="norte" to="caminonortenorte">
      <inherit name="compassdirection" />
      <inherit name="northdirection" />
    </exit>
    <object name="romero">
      <scenery />
      <alt>tomillo; vegetación; vegetacion; plantas; arbustos</alt>
      <look>Simples plantas aromáticas.</look>
      <lick>Le das una chupadita. Hmmmm... sabe delicioso.</lick>
      <mueve>¿Moverlo?¿Para qué?</mueve>
      <touch>No. Podría darte una reacción alérgica.</touch>
      <takemsg>No. Mejor deja las plantas aromáticas donde están. Podrían causarte una reacción alérgica.</takemsg>
      <alias>romero</alias>
      <gender>lo</gender>
      <article>el</article>
      <cortar>No vas a necesitar la vegetación cortada para nada.</cortar>
    </object>
    <object name="camino1">
      <scenery />
      <look>Es un camino empedrado que solamente te permite ir al norte o al sur.</look>
      <alias>camino</alias>
      <gender>lo</gender>
      <article>el</article>
    </object>
    <object name="hierba5">
      <inherit name="female" />
      <gender>la</gender>
      <article>la</article>
      <usedefaultprefix type="boolean">false</usedefaultprefix>
      <scenery />
      <look>Simple hierba. Buena para los conejos.</look>
      <alias>hierba</alias>
      <cortar>No vas a necesitar la vegetación cortada para nada.</cortar>
    </object>
    <object name="piedras5">
      <inherit name="femaleplural" />
      <alias>piedras</alias>
      <scenery />
      <gender>las</gender>
      <article>las</article>
      <look>Simples piedras que conforman el camino.</look>
      <takemsg>No te servirían para nada.</takemsg>
    </object>
  </object>
  <object name="Camino Noroeste">
    <description type="string"></description>
    <usedefaultprefix type="boolean">false</usedefaultprefix>
    <alias>camino</alias>
    <picture>camino noroeste.jpg</picture>
    <prefix>un</prefix>
    <firstenter type="script">
      msg ("Es un camino de tierra. La hierba crece a ambos lados. Hace un día fantástico, los pajarillos revolotean sobre las copas de los árboles. ")
    </firstenter>
    <enter type="script">
      if (ListContains(ScopeVisible(), ciclope)) {
        play sound ("ciclope.mp3", false, false)
        msg ("De pronto, un enorme cíclope se planta ante tí.")
        SetFramePicture ("ciclope.jpg")
        WaitForKeyPress
        msg ("Te mira fijamente, y al cabo de unos segundos, te dice:")
        WaitForKeyPress
        SetForegroundColour ("Red")
        msg ("\"Oye por favor, ¿El camino más corto para llegar al Ninfa's Club?\"")
        SetForegroundColour ("Black")
        msg ("Durante unos minutos te rascas la barba, y luego respondes:")
        SetForegroundColour ("Blue")
        msg ("\"Baja hacia el sur, luego tuerce a la derecha, luego la cuarta a la izquierda, después sigue las luces rojas...\"")
        SetForegroundColour ("Black")
        msg ("El cíclope, se da media vuelta, y sin mirarte a la cara, levantando el brazo derecho en señal de agradecimiento, te dice:")
        SetForegroundColour ("Red")
        msg ("\"Gracias. Si vas por allí te invitaré a una copa\".")
        SetForegroundColour ("Black")
        msg ("Y diciendo estas palabras se aleja por el camino, perdiéndose su silueta al cabo de unos minutos.")
        MoveObject (ciclope, LIMBO)
        SetFramePicture ("camino noroeste.jpg")
      }
    </enter>
    <exit alias="sureste" to="crucecaminos">
      <inherit name="compassdirection" />
      <inherit name="southeastdirection" />
    </exit>
    <exit alias="norte" to="Norte CaminoNoroeste">
      <inherit name="compassdirection" />
      <inherit name="northdirection" />
    </exit>
    <object name="hierba">
      <inherit name="female" />
      <gender>la</gender>
      <article>la</article>
      <usedefaultprefix type="boolean">false</usedefaultprefix>
      <scenery />
      <look>Simple hierba. Buena para los conejos.</look>
      <alias>hierba</alias>
      <cortar>No vas a necesitar la vegetación cortada para nada.</cortar>
    </object>
    <object name="pajarillos">
      <scenery />
      <gender>los</gender>
      <article>los</article>
      <look>Simples pajarillos. Buena comida para los halcones y águilas que habitan por aquí.</look>
      <alt>pajaros; pájaros</alt>
      <alias>pajarillos</alias>
    </object>
    <object name="copas">
      <scenery />
      <gender>las</gender>
      <article>las</article>
      <look>No son para beber. Son las copas de los árboles.</look>
      <alias>copas</alias>
    </object>
    <object name="arboles">
      <scenery />
      <gender>los</gender>
      <article>los</article>
      <look>Pues... árboles. Seguro que has visto muchos en tu vida.</look>
      <alt>árboles; árbol; arbol</alt>
      <alias>árboles</alias>
    </object>
    <object name="tierra">
      <alt>suelo</alt>
      <scenery />
      <look><![CDATA[Simple "<b><i>polvo</i></b>" en el camino.]]></look>
      <gender>la</gender>
      <article>la</article>
      <alias>tierra</alias>
    </object>
    <object name="polvo">
      <scenery />
      <look><![CDATA[Hmmmmm... mejor no. <br/>No estoy seguro de que seas mayor de edad. ;)]]></look>
      <alias>polvo</alias>
      <gender>lo</gender>
      <article>el</article>
    </object>
    <object name="conejo">
      <scenery />
      <look><![CDATA[Lo siento. No hay ninguna mujer por aquí cerca. <br/>;)]]></look>
      <alt>conejos</alt>
      <alias>conejo</alias>
      <gender>lo</gender>
      <article>el</article>
    </object>
    <object name="camino4">
      <scenery />
      <alias>camino</alias>
      <gender>lo</gender>
      <article>el</article>
    </object>
  </object>
  <object name="Norte CaminoNoroeste">
    <description type="string"></description>
    <usedefaultprefix type="boolean">false</usedefaultprefix>
    <alias>camino</alias>
    <picture>norte camino noroeste.jpg</picture>
    <prefix>un</prefix>
    <firstenter type="script">
      msg ("Este camino te recuerda tu amada Macedonia. Qué día tan maravilloso. Ojalá pudieses pasear junto a tus veinte esclavas persas, y admirar con ellas el paisaje de este día primaveral. Después, retozarías con alguna de ellas sobre la verde hierba del lugar. ")
    </firstenter>
    <exit alias="sur" to="Camino Noroeste">
      <inherit name="compassdirection" />
      <inherit name="southdirection" />
    </exit>
    <exit alias="noroeste" to="NorteCaminoNoroesteNoroeste">
      <inherit name="compassdirection" />
      <inherit name="northwestdirection" />
    </exit>
    <object name="hierba2">
      <inherit name="female" />
      <gender>la</gender>
      <article>la</article>
      <usedefaultprefix type="boolean">false</usedefaultprefix>
      <scenery />
      <look>Simple hierba. Buena para los conejos.</look>
      <alias>hierba</alias>
      <cortar>No vas a necesitar la vegetación cortada para nada.</cortar>
    </object>
    <object name="pajarillos1">
      <scenery />
      <gender>los</gender>
      <article>los</article>
      <look>Simples pajarillos. Buena comida para los halcones y águilas que habitan por aquí.</look>
      <alt>pajaros; pájaros</alt>
      <alias>pajarillos</alias>
    </object>
    <object name="copas1">
      <scenery />
      <gender>las</gender>
      <article>las</article>
      <look>No son para beber. Son las copas de los árboles.</look>
      <alias>copas</alias>
    </object>
    <object name="arboles2">
      <scenery />
      <gender>los</gender>
      <article>los</article>
      <look>Pues... árboles. Seguro que has visto muchos en tu vida.</look>
      <alt>árboles; árbol; arbol</alt>
      <alias>árboles</alias>
    </object>
    <object name="tierra1">
      <alt>suelo</alt>
      <scenery />
      <look><![CDATA[Simple "<b><i>polvo</i></b>" en el camino.]]></look>
      <gender>la</gender>
      <article>la</article>
      <alias>tierra</alias>
    </object>
    <object name="polvo1">
      <scenery />
      <look><![CDATA[Hmmmmm... mejor no. <br/>No estoy seguro de que seas mayor de edad. ;)]]></look>
      <alias>polvo</alias>
      <gender>lo</gender>
      <article>el</article>
    </object>
    <object name="conejo1">
      <scenery />
      <look><![CDATA[Lo siento. No hay ninguna mujer por aquí cerca. <br/>;)]]></look>
      <alt>conejos</alt>
      <alias>conejo</alias>
      <gender>lo</gender>
      <article>el</article>
    </object>
    <object name="paisaje">
      <scenery />
      <look><![CDATA[Primaveral. <br/>Idóneo para retozar y echar un kiki.]]></look>
      <alias>paisaje</alias>
      <gender>lo</gender>
      <article>el</article>
    </object>
    <object name="camino5">
      <scenery />
      <look>Es un camino persa. A algún sitio llevará...</look>
      <alias>camino</alias>
      <gender>lo</gender>
      <article>el</article>
    </object>
  </object>
  <object name="NorteCaminoNoroesteNoroeste">
    <description type="string"></description>
    <alias>camino</alias>
    <usedefaultprefix type="boolean">false</usedefaultprefix>
    <picture>NorteCaminoNoroesteNoroeste.jpg</picture>
    <prefix>un</prefix>
    <firstenter type="script">
      msg ("Desde aquí, pareces divisar el humo de alguna hoguera hacia el norte. ")
    </firstenter>
    <exit alias="sureste" to="Norte CaminoNoroeste">
      <inherit name="compassdirection" />
      <inherit name="southeastdirection" />
    </exit>
    <exit alias="norte" to="CasaViejo">
      <inherit name="compassdirection" />
      <inherit name="northdirection" />
    </exit>
    <object name="hierba3">
      <inherit name="female" />
      <gender>la</gender>
      <article>la</article>
      <usedefaultprefix type="boolean">false</usedefaultprefix>
      <scenery />
      <look>Simple hierba. Buena para los conejos.</look>
      <alias>hierba</alias>
      <cortar>No vas a necesitar la vegetación cortada para nada.</cortar>
    </object>
    <object name="humo">
      <alt>fogata; fuego; hoguera; humareda</alt>
      <scenery />
      <look>No ves la hoguera, pero el humo parece provenir de alguna fogata situada en la zona norte. Desde aquí solo ves, y hueles el humo que proviene de ella.</look>
      <oler>Huele a humo. Simple humo. Nada de tocino a la brasa, ni cosas de esas que tienen colesterol.</oler>
      <alias>humo</alias>
    </object>
    <object name="camino6">
      <scenery />
      <look>Es un camino persa. A algún sitio llevará...</look>
      <alias>camino</alias>
    </object>
  </object>
  <command name="MUSICA OFF">
    <pattern>musica off; desactivar musica</pattern>
    <script>
      stop sound
    </script>
  </command>
  <command name="MUSICA ON">
    <pattern>musica on; activar musica</pattern>
    <script>
      play sound ("nearco.wav", false, false)
    </script>
  </command>
  <object name="CasaViejo">
    <alias>un camino, delante de una pequeña choza</alias>
    <description><![CDATA[Un anciano está sentado en el suelo con las piernas cruzadas, junto a una pequeña choza. <br/>Hay una pequeña hoguera a su derecha. ]]></description>
    <picture>casaviejo.jpg</picture>
    <usedefaultprefix type="boolean">false</usedefaultprefix>
    <enter type="script">
      stop sound
      if (Viejo.ALEGRE = false) {
        msg ("El anciano, con la mirada perdida en la hoguera, sin verla debido a su ceguera, intuye tu presencia y sin mover la cabeza te dice:")
        SetForegroundColour ("Blue")
        msg ("\"¡Hola Nearco! Te preguntarás como sé tu nombre. Lo sé absolutamente todo sobre ti. Tu pasado, tu presente y tu futuro. Sé la misión que tienes encomendada. Yo he perdido algo, y solo si me ayudas a encontrarlo te dejaré pasar por mis tierras para que encuentres lo que buscas...\"")
        SetForegroundColour ("Black")
        Viejo.ALEGRE = true
      }
      else {
        if (Viejo.respondido = false) {
          msg ("El anciano, sin apartar la mirada de la hoguera, te pregunta:")
          SetForegroundColour ("Blue")
          msg ("Dime Nearco. ¿Has encontrado ya, lo que ando buscando? ¿Me ayudarás?")
          SetForegroundColour ("Black")
        }
        else {
          msg ("El anciano, absorto en su número pandigital, no te hace ni el más mínimo puñetero caso...")
        }
      }
    </enter>
    <object name="hoguera">
      <usedefaultprefix type="boolean">false</usedefaultprefix>
      <alias>una hoguera</alias>
      <look>No es nada del otro mundo. Una hoguera normal y corriente... Son más bonitas las de Alicante.</look>
      <alt>fuego; llama; lumbre; rescoldos; brasa; brasas</alt>
      <gender>la</gender>
      <article>la</article>
      <touch>No. Te quemarías.</touch>
      <oler>La hoguera huele a humo.</oler>
      <useon type="scriptdictionary">
        <item key="casco">
          msg ("Podrías poner el casco en el fuego a modo de caldero. Pero no tienes nada que puedas cocer dentro del casco.")
        </item>
        <item key="espada">
          msg ("Calientas la espada, hasta que se pone al rojo vivo... después se enfría y vuelve a su estado natural.")
        </item>
        <item key="numero">
          msg ("Acercas el pergamino a la hoguera y ves con satisfacción como en el hueco del número que falta van apareciendo unos caracteres. El pergamino te lo han enviado los dioses y es incombustible pero crees distinguir unas palabras que han aparecido con el calor. Con cuidado y sin quemarte, recuperas el pergamino y en el hueco del número que falta lees: “Jhames es un borde”.")
        </item>
      </useon>
    </object>
    <exit alias="sur" to="NorteCaminoNoroesteNoroeste">
      <inherit name="compassdirection" />
      <inherit name="southdirection" />
    </exit>
    <exit name="CaminoADestruir" alias="norte" to="CaminoCementerio">
      <inherit name="compassdirection" />
      <locked type="boolean">false</locked>
      <lockmessage type="string"></lockmessage>
      <script type="script">
        play sound ("golpenortecasadelviejo.mp3", false, false)
        msg ("Una fuerza invisible no te deja continuar. Lo intentas. Quieres mover tus piernas, pero no lo consigues. No hay forma de que puedas avanzar. Es como si te golpearas contra un muro de cristal...")
      </script>
    </exit>
    <object name="choza">
      <scenery />
      <look>Es una choza de madera muy modesta. Lo suficiente como para que el viejo pueda sobrevivir.</look>
      <entrar>No. No te apetece. Además el anciano no te ha dicho que puedas pasar a la choza.</entrar>
      <entrarenla>No. No te apetece. Además el anciano no te ha dicho que puedas pasar a la choza.</entrarenla>
      <entraenla>No. No te apetece. Además el anciano no te ha dicho que puedas pasar a la choza.</entraenla>
      <pasar>No. No te apetece. Además el anciano no te ha dicho que puedas pasar a la choza.</pasar>
      <pasarala>No. No te apetece. Además el anciano no te ha dicho que puedas pasar a la choza.</pasarala>
      <entraren>No. No te apetece. Además el anciano no te ha dicho que puedas pasar a la choza.</entraren>
      <abrir>Ni se te ocurra. El viejo te abriría la cabeza con el palo.</abrir>
      <oler>La choza huele a humo</oler>
      <romper>Ni se te ocurra. El viejo te abriría la cabeza con el palo.</romper>
      <touch>Ni se te ocurra. El viejo te abriría la cabeza con el palo.</touch>
      <gender>la</gender>
      <article>la</article>
      <alias>choza</alias>
      <alt>madera</alt>
    </object>
    <object name="piernas">
      <scenery />
      <look>Delgaduchas. Las tiene cruzadas.</look>
      <gender>las</gender>
      <article>las</article>
      <alias>piernas</alias>
    </object>
    <object name="arena1">
      <scenery />
      <look>Arena. Fínisima, compuesta por miles de millones de trillones de granos. En ella hay dibujados montones de círculos, triángulos y números.</look>
      <alt>suelo; tierra</alt>
      <gender>la</gender>
      <article>la</article>
      <alias>arena</alias>
    </object>
    <object name="circulos">
      <scenery />
      <alt>números; triángulos; triangulos; triángulo; triangulo; circulos; círculo; circulo</alt>
      <look>Son extraños dibujos realizados con un palo sobre la arena, que para tí, no tienen ningún sentido.</look>
      <alias>círculos</alias>
      <gender>los</gender>
      <article>los</article>
    </object>
    <object name="hierba7">
      <inherit name="female" />
      <gender>la</gender>
      <article>la</article>
      <usedefaultprefix type="boolean">false</usedefaultprefix>
      <scenery />
      <look>Simple hierba. Buena para los conejos.</look>
      <alias>hierba</alias>
      <cortar>No vas a necesitar la vegetación cortada para nada.</cortar>
    </object>
    <object name="camino7">
      <scenery />
      <look>Es un camino persa. A algún sitio llevará...</look>
      <alias>camino</alias>
    </object>
    <object name="Viejo">
      <inherit name="male" />
      <touch>Lo tocas un poquito... y vaya.. parece que le gusta... Tú, por si acaso, empiezas a guardar las distancias.</touch>
      <oler>Huele regular. Das un respingo hacia atrás disimulando después de olerlo. Creo que hace años que no se ha lavado.</oler>
      <mover>No conseguirías nada moviendo al anciano. Además, no se deja mover.</mover>
      <lick>Le das una chupadita. Sabe a viejo de limón.</lick>
      <kill>A veces te dan ganas... pero será mejor dejarlo vivir. Todavía es muy joven.</kill>
      <hit>No. Pobrecillo. Ya está mayor, y parece pacífico.</hit>
      <empujar>No. Pobrecillo. Ya está mayor.</empujar>
      <ayudar>Ojalá supieses como.</ayudar>
      <gender>lo</gender>
      <usedefaultprefix />
      <respondido type="boolean">false</respondido>
      <alt>abuelo; Piruletias; viejo; abuelo; barba</alt>
      <look>Ves a un señor muy anciano sentado en el suelo, junto a una choza de madera, con las piernas cruzadas como si estuviese meditando, mientras que con un palo dibuja círculos y hace números sobre la poca arena que hay en este lugar. Observas que sus ojos son completamente blancos, lo cual, junto a su larga barba blanca le da un aspecto, como menos, impactante.</look>
      <ALEGRE type="boolean">false</ALEGRE>
      <alias>anciano</alias>
      <telldefault type="script">
        msg ("El viejo está absorto en sus círculos y no te dice nada.")
      </telldefault>
      <useon type="scriptdictionary">
        <item key="casco">
          msg ("Se lo pones un momentito... Lo miras. Nap. No le sienta bien. Se lo quitas, y te lo vuelves a poner.")
        </item>
        <item key="espada">
          msg ("Pobrecillo. Sé que se lo merece, pero aún es muy joven para morir.")
        </item>
        <item key="numero">
          msg ("El viejo te mira y te dice:")
          SetForegroundColour ("Blue")
          msg ("\"Eres tú el que me tienes que dar el número que falta. Averígualo.\"")
          SetForegroundColour ("Black")
        </item>
      </useon>
      <tell type="scriptdictionary">
        <item key="hoguera fuego fogata humo">
          msg ("El viejo dice:")
          SetForegroundColour ("Blue")
          msg ("La hoguera es para mantenerme calentito. Ahora mismo empezará a anocher, y aquí hace un frío que pela")
          SetForegroundColour ("Black")
        </item>
        <item key="choza cabaña casa hogar">
          msg ("El viejo dice:")
          SetForegroundColour ("Blue")
          msg ("\"Te invitaría a pasar, pero es que aún no ha venido la señora de la limpieza, y lo tengo todo revuelto. Hoy se está retrasando...\"")
          SetForegroundColour ("Black")
        </item>
        <item key="serpiente víbora serpiente ofidio">
          msg ("El viejo dice:")
          SetForegroundColour ("Blue")
          msg ("Ah... te estarás refiriendo a la gran serpiente del bosque. Que los dioses te ayuden Nearco...Sí, eso, que los dioses te ayuden. Yo no puedo decirte gran cosa. Siempre le he tenido miedo.")
          SetForegroundColour ("Black")
        </item>
        <item key="zanahoria">
          msg ("El viejo dice:")
          SetForegroundColour ("Blue")
          msg ("\"Vaya... veo que te has leído las instrucciones del principio. Vale.. vale.. muy bien.... pero en este juego no hay ninguna zanahoria.!")
          SetForegroundColour ("Black")
        </item>
        <item key="nerea ninfa">
          msg ("El viejo dice:")
          SetForegroundColour ("Blue")
          msg ("\"Fue mi amante hace unos años... ahora los quiere más jóvenes... Menuda zorr... digo Menuda Ninfa.\"")
          SetForegroundColour ("Black")
        </item>
        <item key="cementerio tumba tumbas losa ">
          msg ("El viejo dice:")
          SetForegroundColour ("Blue")
          msg ("\"Pronto yo estaré allí, pero de momento me entretengo con las matemáticas...\"")
          SetForegroundColour ("Black")
        </item>
        <item key="roca rocas">
          msg ("El viejo dice:")
          SetForegroundColour ("Blue")
          msg ("\"Hay muchas por los acantilados. Son grandes y redondas. Seguro que te darán un empujón para terminar esta aventura.\"")
          SetForegroundColour ("Black")
        </item>
        <item key="pajaro pajaros pajarillos">
          msg ("El viejo dice:")
          SetForegroundColour ("Blue")
          msg ("\"Están gordos como borregos, no sé de que se alimentarán los muy cabritos...\"")
          SetForegroundColour ("Black")
        </item>
        <item key="hola buenas buenos días buenos dias buenas tardes">
          msg ("El viejo dice:")
          SetForegroundColour ("Blue")
          msg ("\"Buenos días Nearco...Apresúrate que pronto se va a hacer de noche...\"")
          SetForegroundColour ("Black")
        </item>
        <item key="nombre llamas">
          msg ("El viejo dice:")
          SetForegroundColour ("Blue")
          msg ("\"Por aquí me conocen como el sabio Piruletias.\"")
          SetForegroundColour ("Black")
        </item>
        <item key="ayuda ayudar">
          msg ("El viejo dice:")
          SetForegroundColour ("Blue")
          msg ("\"Gracias Nearco. Claro que me puedes ayudar. Puedes empezar por deshacerte de la gran serpiente del bosque, que me da mucho miedo por las noches...Y que los dioses te ayuden a tí.\"")
          SetForegroundColour ("Black")
        </item>
        <item key="si sí claro ok">
          if (ListContains(ScopeVisible(), ninfa)) {
          }
          else if (ListContains(ScopeVisible(), Viejo)) {
            msg ("El anciano te dice:")
            SetForegroundColour ("Blue")
            msg ("\"Pues venga. Date prisa. Dímelo. ¿Qué es?¿Dime la solución?\"")
            SetForegroundColour ("Black")
          }
          else {
            msg ("Dices \"Sí\", (alqo que juraste no volver a decir desde que te divorciaste de Prusenila), pero solo escuchas el eco de tu propia voz.")
          }
          if (player.parent = sitiodelaninfa) {
            if (ListContains(ScopeVisible(), ninfa)) {
              msg ("La ninfa te dice:")
              SetForegroundColour ("Blue")
              msg ("\"Entra en el laberinto de la estrellas, busca la natividad del hijo de Zeus y Olimpia, y pronuncia mi nombre: \"Nerea\" junto al año en que vio la luz del Sol. Si lo haces correctamente podrás encontrar el nombre de mi amado, y yo podré reunirme con él. Así, podrás seguir con tu destino. ¡¡¡ Que la gloria de Aquiles te acompañe!!!\"")
              SetForegroundColour ("Black")
              play sound ("ninfaseva.mp3", false, false)
              msg ("Como por arte de magia, mientras la ninfa se desvanece, un pasillo se abre entre la vegetación, permitiéndote ir hacia el norte.")
              create exit ("norte", sitiodelaninfa, Pasadizo_horoscopo)
              MoveObject (ninfa, LIMBO)
              ninfa.contestada = true
              SetFramePicture ("sitiodelaninfa.jpg")
            }
          }
          else {
          }
        </item>
        <item key="1036957284">
          msg ("El anciano, saltando de alegría, te dice:")
          SetForegroundColour ("Blue")
          msg ("¡¡¡Si!!! Ese es el número que yo buscaba. Es el número que me faltaba de este maravilloso cuadrado mágico de orden 4. Tiene la sorprendente característica de ser pandigital, es decir, que cada elemento está formado por las diez cifras decimales sin repetir ninguna y además la suma de sus filas, columnas y diagonales es también pandigital (4129607358). Probablemente es la matriz pandigital de orden 4 menor posible, dado que se pueden construir otras pero con números mayores ¡Es una joya matemática casi incomparable!")
          SetForegroundColour ("Black")
          msg ("La fuerza invisible que te impedía el paso hacia el norte, desaparece...")
          create exit ("norte", CasaViejo, CaminoCementerio)
          destroy ("CaminoADestruir")
          play sound ("campanillas.mp3", false, false)
          Viejo.respondido = true
        </item>
        <item key="jhames">
          msg ("El viejo dice:")
          SetForegroundColour ("Blue")
          msg ("\"A mí me parece un tío muy inteligente, y además con muy buena planta. Verás como las generaciones venideras hablan de sus aventuras. Sí. También sé predecir el futuro... pero ahora no me preguntes por el tuyo.\"")
          SetForegroundColour ("Black")
        </item>
        <item key="número numero pergamino numeros números">
          if (player.parent = CasaViejo) {
            msg ("El viejo te mira y te dice:")
            SetForegroundColour ("Blue")
            msg ("\"Es un viejo pergamino enviado por los dioses. Eres tú el que tienes que descifrar el número que falta y decírmelo. Es el número perdido que te abrirá algunas puertas. Averígualo.\"")
            SetForegroundColour ("Black")
          }
          else {
            msg ("Aquí no está el anciano.")
          }
        </item>
      </tell>
      <ask type="scriptdictionary" />
      <give type="scriptdictionary">
        <item key="casco">
          msg ("El viejo coge el casco, se lo pone, mueve un poco la cabeza. Luego te lo devuelve y dice:")
          SetForegroundColour ("Blue")
          msg ("\"No lo quiero Nearco, con ese casco no escucho bien a los dioses y no consigo concentrarme en mis círculos\"")
          SetForegroundColour ("Black")
          msg ("Después de dicho ésto, te devuelve el casco.")
        </item>
        <item key="barbuquejo">
          msg ("El viejo no quiere el barbuquejo para nada.")
        </item>
        <item key="espada">
          msg ("El viejo mira la espada, y la rechaza. Creo que se declaró antibelicista en su juventud.")
        </item>
        <item key="numero">
          msg ("El viejo te mira y te dice:")
          SetForegroundColour ("Blue")
          msg ("\"Eres tú el que me tienes que dar el número que falta. Averígualo.\"")
          SetForegroundColour ("Black")
        </item>
        <item key="antiserpientes">
          msg ("El antiserpientes es para usarlo con la serpiente. El anciano ya no se acuerda de como tiene que agitar cosas cilíndricas para que esten en perfecto estado de uso.")
        </item>
      </give>
    </object>
    <object name="palo">
      <scenery />
      <look>Un simple palo de madera sin mayor importancia en este juego.</look>
      <takemsg>Es el palo con el que el viejo pinta sus dibujos. Quitárselo sería como quitarle un caramelo a un niño, rebozarlo en excrementos de caballo persa, y volvérselo a entregar. Y tú, no tienes tan mal corazón...</takemsg>
      <alias>palo</alias>
    </object>
  </object>
  <object name="CaminoCementerio">
    <alias>camino</alias>
    <description type="string"></description>
    <usedefaultprefix type="boolean">false</usedefaultprefix>
    <picture>buho.jpg</picture>
    <prefix>un</prefix>
    <enter type="script"><![CDATA[
      stop sound
      ClearScreen
      SetBackgroundColour ("Black")
      SetForegroundColour ("White")
      play sound ("buho.mp3", false, false)
      msg ("Al llegar a este punto del camino, empieza a oscurecer. Se va haciendo de noche y escuchas a una lechuza ulular, mientras te mira sorprendida, con sus brillantes ojos amarillos, pensando qué se te puede haber perdido en estos lóbregos parajes... <br/>Tú piensas: \"Extraños parajes son éstos, Nearco\"")
    ]]></enter>
    <exit alias="noroeste" to="cementerio">
      <inherit name="compassdirection" />
      <inherit name="northwestdirection" />
    </exit>
    <exit alias="sureste" to="Camino cementerio1">
      <inherit name="compassdirection" />
      <inherit name="southeastdirection" />
    </exit>
    <object name="buho">
      <scenery />
      <look>Es una lechuza inquietante. Sus ojos amarillos están clavados en ti. Apenas si parpadean, y eso hace que te sientas intranquilo...</look>
      <alt>lechuza; búho; ojos</alt>
      <alias>búho</alias>
    </object>
    <object name="camino8">
      <scenery />
      <look>Es un camino persa. A algún sitio llevará...</look>
      <alias>camino</alias>
    </object>
  </object>
  <object name="caminonortenorte">
    <description type="string"></description>
    <picture>caminonortenorte.jpg</picture>
    <usedefaultprefix type="boolean">false</usedefaultprefix>
    <alias>camino</alias>
    <prefix>un</prefix>
    <firstenter type="script">
      msg ("Aquí la vegetación se espesa. La maleza está más alta. Al noreste ves un bosque. ")
    </firstenter>
    <exit alias="sur" to="Camino Norte">
      <inherit name="compassdirection" />
      <inherit name="southdirection" />
    </exit>
    <exit alias="noreste" to="sitiodelaninfa">
      <inherit name="compassdirection" />
      <inherit name="northeastdirection" />
    </exit>
    <object name="maleza">
      <scenery />
      <look>Broza y matorrales que se van espesando.</look>
      <alt>matorral; matorrales; broza; vegetacion; vegetación; hojarasca; hojas</alt>
      <gender>la</gender>
      <article>la</article>
      <alias>maleza</alias>
      <cortar>No vas a necesitar la vegetación cortada para nada.</cortar>
      <takemsg>Coger la vegetación de la zona no te va servir para nada.</takemsg>
    </object>
    <object name="bosque">
      <scenery />
      <look>Es el bosque que está al noreste.</look>
      <alt>árbol; arbol; árboles; arboles</alt>
      <alias>bosque</alias>
    </object>
    <object name="camino2">
      <scenery />
      <look>El camino está casi cubierto por la vegetación, pero de momento se puede distinguir perfectamente. Desde aquí solamente te puedes dirigir al sur o al noreste.</look>
      <alias>camino</alias>
    </object>
    <object name="hierba8">
      <inherit name="female" />
      <gender>la</gender>
      <article>la</article>
      <usedefaultprefix type="boolean">false</usedefaultprefix>
      <scenery />
      <look>Simple hierba. Buena para los conejos.</look>
      <alias>hierba</alias>
      <cortar>No vas a necesitar la vegetación cortada para nada.</cortar>
    </object>
  </object>
  <object name="sitiodelaninfa">
    <description>Has entrado dentro del bosque. Una gran cantidad de árboles te rodea.</description>
    <usedefaultprefix type="boolean">false</usedefaultprefix>
    <alias>el bosque</alias>
    <picture>sitiodelaninfa.jpg</picture>
    <firstenter type="script">
      msg ("Parece que este lugar tiene un aire un tanto mágico.")
      msg ("Eres incapaz de adentrarte mucho más. Tu única salida cierta está al suroeste.")
    </firstenter>
    <enter type="script">
      if (ListContains(ScopeVisible(), ninfa)) {
        msg ("La ninfa, triste, te mira y te dice:")
        SetForegroundColour ("Blue")
        msg ("\"Sé quién eres, Nearco. Mi corazón sufre una gran pena. Mi amado murió y está enterrado en el cementerio, pero los dioses borraron de mi memoria su nombre, y si no lo pronuncio, jamás volveré a reunirme con él. ¿Me ayudarás a recordar su nombre?\"")
        SetForegroundColour ("Black")
      }
    </enter>
    <exit alias="suroeste" to="caminonortenorte">
      <inherit name="compassdirection" />
      <inherit name="southwestdirection" />
      <locked type="boolean">false</locked>
      <script type="script">
        MoveObject (player, caminonortenorte)
        if (ninfa.contestada = false) {
          MoveObject (ninfa, sitiodelaninfa)
        }
        else {
        }
      </script>
    </exit>
    <object name="arboles1">
      <alias>arboles</alias>
      <scenery />
      <alt>arbol; árboles; arboles; árbol; bosque</alt>
      <look>Aquí, en esta parte del bosque, los árboles tienen un cierto aire misterioso y místico, como si fuesen los custodios de secretos arcanos.</look>
      <gender>los</gender>
      <article>los</article>
    </object>
    <object name="hierba9">
      <inherit name="female" />
      <gender>la</gender>
      <article>la</article>
      <usedefaultprefix type="boolean">false</usedefaultprefix>
      <scenery />
      <look>Simple hierba. Buena para los conejos.</look>
      <alias>hierba</alias>
      <cortar>No vas a necesitar la vegetación cortada para nada.</cortar>
    </object>
  </object>
  <object name="camino norestenoreste">
    <description type="string"></description>
    <alias>camino</alias>
    <usedefaultprefix type="boolean">false</usedefaultprefix>
    <picture>caminohaciapuente.jpg</picture>
    <prefix>un</prefix>
    <pasolibre type="boolean">false</pasolibre>
    <firstenter type="script">
      msg ("¡¡¡ Por el sagrado Aquiles !!! Este camino debe de llevar a algún sitio...")
      WaitForKeyPress
      SetFramePicture ("serpiente.gif")
      msg ("De pronto, sin previo aviso, una enorme serpiente, te corta el paso amenazante...")
      MoveObject (serpiente, camino norestenoreste)
      play sound ("Serpiente.mp3", false, false)
    </firstenter>
    <enter type="script">
      if (camino norestenoreste.pasolibre = false) {
        SetFramePicture ("serpiente.gif")
      }
    </enter>
    <exit alias="suroeste" to="Camino Noreste">
      <inherit name="compassdirection" />
      <inherit name="southwestdirection" />
    </exit>
    <exit alias="norte" to="Puente">
      <inherit name="compassdirection" />
      <inherit name="northdirection" />
      <script type="script">
        if (camino norestenoreste.pasolibre = false) {
          msg ("La serpiente te bloquea el paso. No puedes pasar. De un solo bocado te engulliría. Será mejor que se te ocurra algo...")
        }
        else {
          MoveObject (player, Puente)
        }
      </script>
    </exit>
    <object name="hierba10">
      <inherit name="female" />
      <gender>la</gender>
      <article>la</article>
      <usedefaultprefix type="boolean">false</usedefaultprefix>
      <scenery />
      <look>Simple hierba. Buena para los conejos.</look>
      <alias>hierba</alias>
    </object>
    <object name="camino11">
      <scenery />
      <look>Es un camino persa. A algún sitio llevará...</look>
      <alias>camino</alias>
    </object>
    <object name="vegetación1">
      <alt>tomillo; romero; árboles; arboles; árbol; arbol; suelo; arena; vegetacion</alt>
      <scenery />
      <look>En esta localidad, ahora mismo nada de eso es relevante.</look>
      <alias>vegetación</alias>
      <cortar>No vas a necesitar la vegetación cortada para nada.</cortar>
    </object>
  </object>
  <object name="Puente">
    <description type="string"></description>
    <usedefaultprefix type="boolean">false</usedefaultprefix>
    <alias>un puente</alias>
    <picture>puente1.jpg</picture>
    <prefix>la zona cercana a</prefix>
    <firstenter type="script">
      msg ("Delante de ti ves un puente de cuerdas con tablones suspendido sobre un precipicio. ")
    </firstenter>
    <exit alias="sur" to="camino norestenoreste">
      <inherit name="compassdirection" />
      <inherit name="southdirection" />
    </exit>
    <exit alias="norte" to="puente1">
      <inherit name="compassdirection" />
      <inherit name="northdirection" />
    </exit>
    <object name="puente">
      <scenery />
      <look>Ufff... Desde aquí el puente no parece muy seguro.</look>
      <gender>lo</gender>
      <article>el</article>
      <alias>puente</alias>
    </object>
    <object name="tablones">
      <scenery />
      <look>Desde aquí parece que faltan algunos tablones, y los que quedan, parece que no están en muy buen estado.</look>
      <alias>tablones</alias>
      <gender>los</gender>
      <article>los</article>
      <useon type="scriptdictionary">
        <item key="espada">
          msg ("Golpeas la espada contra lo tablones. Solo consigues astillarlos un poquito.")
        </item>
        <item key="casco">
          msg ("Golpeas el casco contra los tablones. Caray, que bien suenan...")
        </item>
        <item key="numero">
          msg ("Sacas brillo a los tablones con el pergamino. Ahora han quedado relucientes.")
        </item>
      </useon>
    </object>
    <object name="precipicio">
      <scenery />
      <look>Es bastante alto. Vamos que seguro que si te caes al fondo, cruzas al otro barrio, con no se qué barquero. La única forma de atravesar el precipicio es a través del puente.</look>
      <alias>precipicio</alias>
    </object>
    <object name="cuerdas">
      <scenery />
      <look>Desde aquí, las cuerdas que ves en el puente, al menos te parecen robustas.</look>
      <gender>las</gender>
      <article>las</article>
      <alias>cuerdas</alias>
      <cortar>Las cuerdas no te van a servir para nada en este juego, de modo que déjalas donde están para que el resto de aventureros que vendrán detrás de tí, puedan pasar por el puente.</cortar>
      <takemsg>Las cuerdas no te van a servir para nada en este juego, de modo que déjalas donde están para que el resto de aventureros que vendrán detrás de tí, puedan pasar por el puente.</takemsg>
      <romper>Las cuerdas no te van a servir para nada en este juego, de modo que déjalas donde están para que el resto de aventureros que vendrán detrás de tí, puedan pasar por el puente.</romper>
      <useon type="scriptdictionary">
        <item key="casco">
          msg ("Golpeas el casco contra las cuerdas. Se enredan un poquito. Luego lo coges y te lo vuelves a poner.")
        </item>
        <item key="espada">
          msg ("¿Estás loco? El puente podría romperse.")
        </item>
        <item key="numero">
          msg ("Pasas el pergamino por las cuerdas. Ahora están un poquito más limpias.")
        </item>
      </useon>
    </object>
    <object name="hierba11">
      <inherit name="female" />
      <gender>la</gender>
      <article>la</article>
      <usedefaultprefix type="boolean">false</usedefaultprefix>
      <scenery />
      <look>Simple hierba. Buena para los conejos.</look>
      <alias>hierba</alias>
      <cortar>No vas a necesitar la vegetación cortada para nada.</cortar>
    </object>
    <object name="camino12">
      <scenery />
      <look>Es un camino persa. A algún sitio llevará...</look>
      <alias>camino</alias>
    </object>
  </object>
  <object name="puente1">
    <description type="string"></description>
    <picture>tablones puente.jpg</picture>
    <usedefaultprefix type="boolean">false</usedefaultprefix>
    <alias>puente</alias>
    <prefix>un</prefix>
    <firstenter type="script">
      msg ("Estás sobre un puente de cuerdas con tablones suspendido sobre un precipicio. ¡¡¡ El problema es que aquí casi no quedan tablones por donde pasar !!! ")
    </firstenter>
    <exit alias="sur" to="Puente">
      <inherit name="compassdirection" />
      <inherit name="southdirection" />
    </exit>
    <exit alias="noroeste" to="acantilado">
      <inherit name="compassdirection" />
      <inherit name="northwestdirection" />
    </exit>
    <object name="puente2">
      <scenery />
      <look>No parece un puente muy seguro. Está hecho con cuerdas y tablones de madera.</look>
      <alias>puente</alias>
    </object>
    <object name="tablones1">
      <scenery />
      <look>Son tablones de madera. Faltan algunos, y los que quedan, parece que no están en muy buen estado.</look>
      <gender>los</gender>
      <article>los</article>
      <alias>tablones</alias>
      <useon type="scriptdictionary">
        <item key="espada">
          msg ("Golpeas la espada contra lo tablones. Solo consigues astillarlos un poquito.")
        </item>
        <item key="casco">
          msg ("Golpeas el casco contra los tablones. Caray, que bien suenan...")
        </item>
        <item key="numero">
          msg ("Sacas brillo a los tablones con el pergamino. Ahora han quedado relucientes.")
        </item>
      </useon>
    </object>
    <object name="precipicio1">
      <scenery />
      <look>Es bastante alto. Vamos que seguro que si te caes al fondo, cruzas al otro barrio, con no se que barquero. La única forma de atravesar el precipicio es a través del puente.</look>
      <alias>precipicio</alias>
    </object>
    <object name="cuerdas1">
      <scenery />
      <look>Sí. Al menos, las cuerdas que ves en el puente, te parecen robustas.</look>
      <gender>las</gender>
      <article>las</article>
      <alias>cuerdas</alias>
      <cortar>Las cuerdas no te van a servir para nada en este juego, de modo que déjalas donde están para que el resto de aventureros que vendrán detrás de tí, puedan pasar por el puente.</cortar>
      <takemsg>Las cuerdas no te van a servir para nada en este juego, de modo que déjalas donde están para que el resto de aventureros que vendrán detrás de tí, puedan pasar por el puente.</takemsg>
      <romper>Las cuerdas no te van a servir para nada en este juego, de modo que déjalas donde están para que el resto de aventureros que vendrán detrás de tí, puedan pasar por el puente.</romper>
      <useon type="scriptdictionary">
        <item key="espada">
          msg ("Golpeas el casco contra las cuerdas. Se enredan un poquito. Luego lo coges y te lo vuelves a poner.")
        </item>
        <item key="casco">
          msg ("¿Estás loco? El puente podría romperse.")
        </item>
        <item key="numero">
          msg ("Pasas el pergamino por las cuerdas. Ahora están un poquito más limpias.")
        </item>
      </useon>
    </object>
    <object name="hierba12">
      <inherit name="female" />
      <gender>la</gender>
      <article>la</article>
      <usedefaultprefix type="boolean">false</usedefaultprefix>
      <scenery />
      <look>Simple hierba. Buena para los conejos.</look>
      <alias>hierba</alias>
      <cortar>No vas a necesitar la vegetación cortada para nada.</cortar>
    </object>
    <object name="camino13">
      <scenery />
      <look>Es un camino persa. A algún sitio llevará...</look>
      <alias>camino</alias>
    </object>
  </object>
  <object name="acantilado">
    <description type="string"></description>
    <picture>acantilado1.jpg</picture>
    <usedefaultprefix type="boolean">false</usedefaultprefix>
    <alias>acantilado</alias>
    <prefix>un</prefix>
    <firstenter type="script">
      msg ("Desde aquí el fresco viento del mar azota tu cara. Allá abajo ves la playa y al norte, la inmensidad del azul del mar. ")
      play sound ("Costa0.mp3", false, false)
    </firstenter>
    <exit alias="sureste" to="puente1">
      <inherit name="compassdirection" />
      <inherit name="southeastdirection" />
    </exit>
    <exit alias="oeste" to="cornisa">
      <inherit name="compassdirection" />
      <inherit name="westdirection" />
    </exit>
    <object name="mar">
      <scenery />
      <look>Su inmensidad te produce sensación de tranquilidad y bienestar. El olor a mar siempre te ha atraído. (No tanto como el olor femenino, pero casi...)</look>
      <oler>Desde aquí hueles el mar. Su olor es característico: salitre, una mezcla de arena mojada, sal y pescado (fresco), y últimamente estás oliendo también una brisa fresca que te hace sentirte muy bien, y respirar a pleno pulmón crema de sol, esterillas, y sardinas asadas.</oler>
      <alias>mar</alias>
      <ask type="scriptdictionary" />
    </object>
    <object name="playa">
      <scenery />
      <look>La playa de finísima arena que ves bajo los acantilados se extiende varios kilómetros.</look>
      <alt>costa</alt>
      <alias>playa</alias>
    </object>
    <object name="viento">
      <scenery />
      <look>Al viento de esta zona,se ve que le va el sadomasoquismo, porque ¡¡¡ te está "azotando"en la cara !!!</look>
      <alias>viento</alias>
    </object>
    <object name="vistaacantilado">
      <alias>acantilado</alias>
      <scenery />
      <look>La visión de este acantilado es magnífica.</look>
    </object>
    <object name="hierba13">
      <inherit name="female" />
      <gender>la</gender>
      <article>la</article>
      <usedefaultprefix type="boolean">false</usedefaultprefix>
      <scenery />
      <look>Simple hierba. Buena para los conejos.</look>
      <alias>hierba</alias>
      <cortar>No vas a necesitar la vegetación cortada para nada.</cortar>
    </object>
    <object name="camino14">
      <scenery />
      <look>Es un camino persa. A algún sitio llevará...</look>
      <alias>camino</alias>
    </object>
  </object>
  <object name="Tauro">
    <description type="string"></description>
    <picture>tauro.gif</picture>
    <alias>la casa de Tauro</alias>
    <usedefaultprefix type="boolean">false</usedefaultprefix>
    <firstenter type="script">
      msg ("Pero bueno... ¿Es que todos los signos zodiacales tienen que recordarme maridos que nunca he conocido? ")
    </firstenter>
    <enter type="script">
      play sound ("Grillos nocturnos1.mp3", false, false)
    </enter>
    <exit alias="oeste" to="Aries">
      <inherit name="compassdirection" />
      <inherit name="westdirection" />
    </exit>
    <exit alias="sureste" to="Geminis">
      <inherit name="compassdirection" />
      <inherit name="southeastdirection" />
    </exit>
    <object name="estrella">
      <inherit name="plural" />
      <scenery />
      <gender>las</gender>
      <article>las</article>
      <alias>estrellas</alias>
      <alt>estrella; firmamento; cielo</alt>
      <look>Las estrellas brillan de una forma muy peculiar. El agradable olor a galán de noche, y su mera contemplación hacen que te sientas bien contigo mismo.</look>
    </object>
  </object>
  <object name="Geminis">
    <description type="string"></description>
    <picture>geminis.gif</picture>
    <usedefaultprefix type="boolean">false</usedefaultprefix>
    <alias>la casa de Géminis</alias>
    <firstenter type="script">
      msg ("Dos hombres que se dan la espalda. Menos mal. Lo malo sería que uno le diese la espalda al otro, y el otro... no se la diese. (Sobre todo... si están desnudos) ")
    </firstenter>
    <enter type="script">
      play sound ("Grillos nocturnos.mp3", false, false)
    </enter>
    <exit alias="noroeste" to="Tauro">
      <inherit name="compassdirection" />
      <inherit name="northwestdirection" />
    </exit>
    <exit alias="sur" to="Cancer">
      <inherit name="compassdirection" />
      <inherit name="southdirection" />
    </exit>
    <object name="estrella1">
      <inherit name="plural" />
      <scenery />
      <gender>las</gender>
      <article>las</article>
      <alias>estrellas</alias>
      <alt>estrella; firmamento; cielo</alt>
      <look>Las estrellas brillan de una forma muy peculiar. El agradable olor a galán de noche, y su mera contemplación hacen que te sientas bien contigo mismo.</look>
    </object>
  </object>
  <object name="Cancer">
    <description type="string"></description>
    <picture>cancer.gif</picture>
    <usedefaultprefix type="boolean">false</usedefaultprefix>
    <alias>la casa de Cáncer</alias>
    <spray type="boolean">false</spray>
    <nerea356 type="boolean">false</nerea356>
    <firstenter type="script">
      msg ("Ves brillar en las estrellas las forma de las pinzas de un cangrejo. ")
    </firstenter>
    <enter type="script">
      play sound ("Grillos nocturnos1.mp3", false, false)
    </enter>
    <exit alias="norte" to="Geminis">
      <inherit name="compassdirection" />
      <inherit name="northdirection" />
    </exit>
    <exit alias="sur" to="Leo">
      <inherit name="compassdirection" />
      <inherit name="southdirection" />
    </exit>
    <object name="estrella2">
      <inherit name="plural" />
      <scenery />
      <gender>las</gender>
      <article>las</article>
      <alias>estrellas</alias>
      <alt>estrella; firmamento; cielo</alt>
      <look>Las estrellas brillan de una forma muy peculiar. El agradable olor a galán de noche, y su mera contemplación hacen que te sientas bien contigo mismo.</look>
    </object>
  </object>
  <object name="Leo">
    <description type="string"></description>
    <picture>leo.gif</picture>
    <alias>la casa de Leo</alias>
    <usedefaultprefix type="boolean">false</usedefaultprefix>
    <firstenter type="script">
      msg ("Te fijas con atención en la silueta que forman las estrellas, y te recuerdan la figura de un león. Inmediatamente, te pones en alerta recordando que esta región está llena de fieras salvajes. ")
    </firstenter>
    <enter type="script">
      play sound ("Grillos nocturnos.mp3", false, false)
    </enter>
    <exit alias="norte" to="Cancer">
      <inherit name="compassdirection" />
      <inherit name="northdirection" />
    </exit>
    <exit alias="suroeste" to="Virgo">
      <inherit name="compassdirection" />
      <inherit name="southwestdirection" />
    </exit>
    <object name="estrella3">
      <inherit name="plural" />
      <scenery />
      <gender>las</gender>
      <article>las</article>
      <alias>estrellas</alias>
      <alt>estrella; firmamento; cielo</alt>
      <look>Las estrellas brillan de una forma muy peculiar. El agradable olor a galán de noche, y su mera contemplación hacen que te sientas bien contigo mismo.</look>
    </object>
  </object>
  <object name="Virgo">
    <description type="string"></description>
    <picture>virgo.gif</picture>
    <alias>la casa de Virgo</alias>
    <usedefaultprefix type="boolean">false</usedefaultprefix>
    <firstenter type="script">
      msg ("Ja. Esta constelación debe ser una broma. Ni en toda Grecia, ni en toda Persia queda una de este tipo. Y menos, desde que tu frecuentas estas tierras. ")
    </firstenter>
    <enter type="script">
      play sound ("Grillos nocturnos1.mp3", false, false)
    </enter>
    <exit alias="noreste" to="Leo">
      <inherit name="compassdirection" />
      <inherit name="northeastdirection" />
    </exit>
    <exit alias="oeste" to="Libra">
      <inherit name="compassdirection" />
      <inherit name="westdirection" />
    </exit>
    <object name="estrella4">
      <inherit name="plural" />
      <scenery />
      <gender>las</gender>
      <article>las</article>
      <alias>estrellas</alias>
      <alt>estrella; firmamento; cielo</alt>
      <look>Las estrellas brillan de una forma muy peculiar. El agradable olor a galán de noche, y su mera contemplación hacen que te sientas bien contigo mismo.</look>
    </object>
  </object>
  <object name="Libra">
    <description type="string"></description>
    <picture>libra.gif</picture>
    <alias>la casa de Libra</alias>
    <usedefaultprefix type="boolean">false</usedefaultprefix>
    <firstenter type="script">
      msg ("En la oscuridad del cielo, la balanza de Libra se refleja en tus pupilas. ")
    </firstenter>
    <enter type="script">
      play sound ("Grillos nocturnos.mp3", false, false)
    </enter>
    <exit alias="este" to="Virgo">
      <inherit name="compassdirection" />
      <inherit name="eastdirection" />
    </exit>
    <exit alias="oeste" to="Escorpio">
      <inherit name="compassdirection" />
      <inherit name="westdirection" />
    </exit>
    <exit alias="sur" to="Pasadizo_horoscopo1">
      <inherit name="compassdirection" />
    </exit>
    <object name="estrella5">
      <inherit name="plural" />
      <scenery />
      <gender>las</gender>
      <article>las</article>
      <alias>estrellas</alias>
      <alt>estrella; firmamento; cielo</alt>
      <look>Las estrellas brillan de una forma muy peculiar. El agradable olor a galán de noche, y su mera contemplación hacen que te sientas bien contigo mismo.</look>
    </object>
  </object>
  <object name="Escorpio">
    <description type="string"></description>
    <picture>escorpio.gif</picture>
    <alias>la casa de Escorpio</alias>
    <usedefaultprefix type="boolean">false</usedefaultprefix>
    <firstenter type="script">
      msg ("La pinzas del cangrejo de la constelación de Escorpio, parecen recordarte que has de sacarle filo a la hoja de tu espada. ")
    </firstenter>
    <enter type="script">
      play sound ("Grillos nocturnos1.mp3", false, false)
    </enter>
    <exit alias="este" to="Libra">
      <inherit name="compassdirection" />
      <inherit name="eastdirection" />
    </exit>
    <exit alias="noroeste" to="Sagitario">
      <inherit name="compassdirection" />
      <inherit name="northwestdirection" />
    </exit>
    <object name="estrella6">
      <inherit name="plural" />
      <scenery />
      <gender>las</gender>
      <article>las</article>
      <alias>estrellas</alias>
      <alt>estrella; firmamento; cielo</alt>
      <look>Las estrellas brillan de una forma muy peculiar. El agradable olor a galán de noche, y su mera contemplación hacen que te sientas bien contigo mismo.</look>
    </object>
  </object>
  <object name="Sagitario">
    <description type="string"></description>
    <picture>sagitario.gif</picture>
    <alias>la casa de Sagitario</alias>
    <usedefaultprefix type="boolean">false</usedefaultprefix>
    <firstenter type="script">
      msg ("Ves brillar un centauro con una arco sobre la oscuridad de la noche, iluminado por fulgurantes estrellas. ")
    </firstenter>
    <enter type="script">
      play sound ("Grillos nocturnos.mp3", false, false)
    </enter>
    <exit alias="sureste" to="Escorpio">
      <inherit name="compassdirection" />
      <inherit name="southeastdirection" />
    </exit>
    <exit alias="norte" to="Capricornio">
      <inherit name="compassdirection" />
      <inherit name="northdirection" />
    </exit>
    <object name="estrella7">
      <inherit name="plural" />
      <scenery />
      <gender>las</gender>
      <article>las</article>
      <alias>estrellas</alias>
      <alt>estrella; firmamento; cielo</alt>
      <look>Las estrellas brillan de una forma muy peculiar. El agradable olor a galán de noche, y su mera contemplación hacen que te sientas bien contigo mismo.</look>
    </object>
  </object>
  <object name="Capricornio">
    <description type="string"></description>
    <picture>capricornio.gif</picture>
    <alias>la casa de Capricornio</alias>
    <usedefaultprefix type="boolean">false</usedefaultprefix>
    <firstenter type="script">
      msg ("Los cuernos de la cabra te recuerdan los miles de maridos que has conocido a través de sus esposas. ")
    </firstenter>
    <enter type="script">
      play sound ("Grillos nocturnos1.mp3", false, false)
    </enter>
    <exit alias="sur" to="Sagitario">
      <inherit name="compassdirection" />
      <inherit name="southdirection" />
    </exit>
    <exit alias="norte" to="Acuario">
      <inherit name="compassdirection" />
      <inherit name="northdirection" />
    </exit>
    <object name="estrella8">
      <inherit name="plural" />
      <scenery />
      <gender>las</gender>
      <article>las</article>
      <alias>estrellas</alias>
      <alt>estrella; firmamento; cielo</alt>
      <look>Las estrellas brillan de una forma muy peculiar. El agradable olor a galán de noche, y su mera contemplación hacen que te sientas bien contigo mismo.</look>
    </object>
  </object>
  <object name="Acuario">
    <description type="string"></description>
    <picture>acuario.gif</picture>
    <alias>la casa de Acuario</alias>
    <usedefaultprefix type="boolean">false</usedefaultprefix>
    <firstenter type="script">
      msg ("Viendo las estrellas parece que tu sed se apaga. ")
    </firstenter>
    <enter type="script">
      play sound ("Grillos nocturnos.mp3", false, false)
    </enter>
    <exit alias="sur" to="Capricornio">
      <inherit name="compassdirection" />
      <inherit name="southdirection" />
    </exit>
    <exit alias="noreste" to="Piscis">
      <inherit name="compassdirection" />
      <inherit name="northeastdirection" />
    </exit>
    <object name="estrella9">
      <inherit name="plural" />
      <scenery />
      <gender>las</gender>
      <article>las</article>
      <alias>estrellas</alias>
      <alt>estrella; firmamento; cielo</alt>
      <look>Las estrellas brillan de una forma muy peculiar. El agradable olor a galán de noche, y su mera contemplación hacen que te sientas bien contigo mismo.</look>
    </object>
  </object>
  <object name="Piscis">
    <description type="string"></description>
    <picture>piscis.gif</picture>
    <alias>la casa de Piscis</alias>
    <usedefaultprefix type="boolean">false</usedefaultprefix>
    <firstenter type="script">
      msg ("Al ver esas estrellas, recuerdas las doradas a la sal que te preparaba tu esclava Zoabel para cenar, en las primaverales noches que pasaste en la isla de Cnossos. ")
    </firstenter>
    <enter type="script">
      play sound ("Grillos nocturnos1.mp3", false, false)
    </enter>
    <exit alias="este" to="Aries">
      <inherit name="compassdirection" />
      <inherit name="eastdirection" />
    </exit>
    <exit alias="suroeste" to="Acuario">
      <inherit name="compassdirection" />
      <inherit name="southwestdirection" />
    </exit>
    <object name="estrella10">
      <inherit name="plural" />
      <scenery />
      <gender>las</gender>
      <article>las</article>
      <alias>estrellas</alias>
      <alt>estrella; firmamento; cielo</alt>
      <look>Las estrellas brillan de una forma muy peculiar. El agradable olor a galán de noche, y su mera contemplación hacen que te sientas bien contigo mismo.</look>
    </object>
  </object>
  <object name="Pasadizo_horoscopo">
    <description>Este es un sitio muy extraño, parece como si la noche se hiciese día, y el día se hiciese noche. </description>
    <alias>un largo corredor del bosque</alias>
    <usedefaultprefix type="boolean">false</usedefaultprefix>
    <picture>deBlancoANegro.jpg</picture>
    <firstenter type="script">
      play sound ("PasadizoHoroscopo.mp3", false, false)
    </firstenter>
    <exit alias="norte">
      <inherit name="northdirection" />
      <script type="script">
        ClearScreen
        SetBackgroundColour ("Black")
        SetForegroundColour ("White")
        SetFramePicture ("deBlancoANegro.jpg")
        msg ("Mientras avanzas, un manto de oscuridad se cierne sobre ti. Se hace de noche, y en el firmamento ves brillar la estrellas.")
        MoveObject (player, Libra)
      </script>
    </exit>
    <exit alias="sur">
      <inherit name="southdirection" />
      <script type="script">
        ClearScreen
        SetBackgroundColour ("White")
        SetForegroundColour ("Black")
        SetFramePicture ("DeNegroABlanco.jpg")
        msg ("Mientras avanzas, la luz del sol se va apoderando de las tinieblas de la noche ...")
        MoveObject (player, sitiodelaninfa)
      </script>
    </exit>
    <object name="corredor">
      <alias>corredor</alias>
      <scenery />
      <look>Este es un sitio muy extraño, parece como si la noche se hiciese día, y el día se hiciese noche. </look>
    </object>
  </object>
  <object name="cementerio1">
    <description type="string"></description>
    <picture>cementerio.jpg</picture>
    <usedefaultprefix type="boolean">false</usedefaultprefix>
    <alias>cementerio</alias>
    <prefix>el</prefix>
    <firstenter type="script">
      msg ("Desde aquí ves muchas fosas, y algunas tumbas tenebrosas. Hasta tus fosas nasales llega un olor nauseabundo. No estás muy seguro si se debe al lugar, o la pestecilla proviene de la parte trasera que está en contacto con tus calzones ...Como eres un valeroso soldado de Alejandro, supones que el aroma proviene de las fosas. (Las nasales). ")
    </firstenter>
    <enter type="script">
      play sound ("misterio.mp3", false, false)
    </enter>
    <object name="tumba">
      <usedefaultprefix type="boolean">false</usedefaultprefix>
      <gender>la</gender>
      <article>la</article>
      <prefix>una</prefix>
      <look>Es una tumba con una losa muy pesada encima. Estás seguro que ni con la fuerza de 5 hoplitas podrías moverla. En la losa hay unas extrañas inscripciones. Intentas traducirlas. Parece que pone algo así como: "Perdone que no me levante señorita, pero desde aquí puedo verle las bragas". Para ti piensas, "Extraño epitafio. ¿A qué mente enferma se le podrían ocurrir estas frases?</look>
      <takemsg>La tumba es muy pesada. No puedes cogerla. Ni siguiera moverla.</takemsg>
      <abrir>Es demasiado pesada.</abrir>
      <mueve>Es demasiado pesada.</mueve>
      <empujar type="string"></empujar>
      <romper>¿Cómo?</romper>
      <touch>Fría. Como la tumba de un cementerio.</touch>
      <alias>tumba</alias>
      <useon type="scriptdictionary">
        <item key="espada">
          msg ("Introduces la espada entre la tumba y la losa, con el objetivo de hacer palanca, pero al ver que la puedes partir, desistes de tu empeño ...")
        </item>
        <item key="casco">
          msg ("Golpeas el casco contra la tumba. Al cabo de un rato, te detienes miras el casco y ves que está abollado.")
        </item>
        <item key="numero">
          msg ("No conseguirás nada enterrando el pergamino.")
        </item>
      </useon>
    </object>
    <object name="losa">
      <look>Demasiado pesada para ti. No puedes moverla. Lo intentas. Pero.. no. No puedes.</look>
      <takemsg>Demasiado pesada para ti. No puedes moverla. Lo intentas. Pero.. no. No puedes.</takemsg>
      <abrir>Demasiado pesada para ti. No puedes moverla. Lo intentas. Pero... no. No puedes.</abrir>
      <mover>Demasiado pesada para ti. No puedes moverla. Lo intentas. Pero... no. No puedes.</mover>
      <usedefaultprefix type="boolean">false</usedefaultprefix>
      <gender>la</gender>
      <article>la</article>
      <alias>losa</alias>
      <prefix>una</prefix>
      <empujar>Demasiado pesada para ti. No puedes moverla. Lo intentas. Pero... no. No puedes.</empujar>
      <romper>¿Cómo?</romper>
      <touch>Fría. Como la losa de un cementerio.</touch>
      <quitar>Demasiado pesada para ti. No puedes moverla. Lo intentas. Pero... no. No puedes.</quitar>
      <subir>Te subes a la losa, y te entra un miedo que te cagas, porque desde aquí ves todo el cementerio. Decides bajarte enseguida, por si acaso...</subir>
      <useon type="scriptdictionary">
        <item key="espada">
          msg ("Aprovechas unos momentitos que tienes, en los que no sabes que hacer, para afilar la espada contra la losa.")
        </item>
        <item key="casco">
          msg ("Golpeas el casco contra la losa, consiguiendo abollarlo un poquito más.")
        </item>
        <item key="numero">
          msg ("Sacas brillo a la losa con el pergamino. Que contenta se va a poner la viuda del difunto cuando vea lo reluciente que está la losa.")
        </item>
      </useon>
    </object>
    <exit alias="sur" to="cementerio">
      <inherit name="compassdirection" />
      <inherit name="southdirection" />
    </exit>
    <object name="tumbas">
      <alt>nichos; fosas</alt>
      <scenery />
      <look>Son tumbas muy antiguas. Casi todas tienen inquilinos en su interior.</look>
      <gender>las</gender>
      <article>las</article>
      <alias>tumbas</alias>
    </object>
    <object name="inscripciontumba">
      <scenery />
      <alt>inscripcion; inscripción; rotulo; rótulo; inscripciones; las inscripciones</alt>
      <look>Es una inscripción arcana. Algún tipo de epitafio. Seguro que para alejar los malos espíritus, y acercar los buenos al difunto.</look>
      <alias>inscripción de la tumba</alias>
      <gender>la</gender>
      <article>la</article>
    </object>
    <object name="camino15">
      <scenery />
      <look>Es un camino persa. A algún sitio llevará...</look>
      <alias>camino</alias>
    </object>
    <object name="cementerioscenery">
      <scenery />
      <look>Es un cementerio tétrico. Yo no podría estar allí, me moriría de pánico. Pareces escuchar fantasmas por todas partes...</look>
      <alias>cementerio</alias>
    </object>
  </object>
  <object name="Camino cementerio1">
    <description type="string"></description>
    <usedefaultprefix type="boolean">false</usedefaultprefix>
    <prefix>un</prefix>
    <alias>camino</alias>
    <picture>camino cementerio1.jpg</picture>
    <firstenter type="script"><![CDATA[
      SetBackgroundColour ("White")
      SetForegroundColour ("Black")
      ClearScreen
      msg ("Está empezando a clarear. <br/>Caray. Qué pronto amanece en este lugar. Los rayos del Sol iluminan tu cara y los pajarillos del bosque empiezan a cantar indicándote que un nuevo día ha comenzado... <br/>(Aunque pensándolo bien, estos pajarillos cantan de una forma muy extraña ... hmmmm..)")
      play sound ("pajaros.mp3", false, false)
    ]]></firstenter>
    <enter type="script"><![CDATA[
      ClearScreen
      SetBackgroundColour ("White")
      SetForegroundColour ("Black")
      msg ("Está empezando a clarear. <br/>Caray. Que pronto amanece en este lugar. Los rayos del Sol iluminan tu cara y los pajarillos del bosque empiezan a cantar indicándote que un nuevo día ha comenzado... <br/>(Aunque pensándolo bien, estos pajarillos cantan de una forma muy extraña... hmmmm..)<br/>Y tú piensas: \"Definitivamente, estos parajes parecen mágicos\"")
    ]]></enter>
    <exit alias="noroeste" to="CaminoCementerio">
      <inherit name="compassdirection" />
      <inherit name="northwestdirection" />
    </exit>
    <exit alias="sur" to="CasaViejo">
      <inherit name="compassdirection" />
      <inherit name="southdirection" />
    </exit>
    <object name="pajaros">
      <scenery />
      <alt>pájaros; los pájaros; los pajaros; los pajarillos; pajarillos</alt>
      <look>Leñe... estos pajarillos están gordos como borregos.</look>
      <gender>los</gender>
      <article>los</article>
      <alias>pájaros</alias>
    </object>
    <object name="camino16">
      <scenery />
      <look>Es un camino persa. A algún sitio llevará...</look>
      <alias>camino</alias>
    </object>
  </object>
  <object name="cornisa">
    <description type="string"></description>
    <picture>acantilado2.jpg</picture>
    <usedefaultprefix type="boolean">false</usedefaultprefix>
    <alias>acantilado</alias>
    <prefix>un</prefix>
    <firstenter type="script">
      msg ("Desde aquí divisas la playa que se extiende varios kilómetros debajo de ti. ")
      msg ("A lo lejos ves una gaviota que pasa volando, y se aleja de la costa, posiblemente buscando algún pescado que llevarse al estómago.")
      play sound ("Costa1.mp3", false, false)
    </firstenter>
    <object name="roca">
      <usedefaultprefix type="boolean">false</usedefaultprefix>
      <prefix>una</prefix>
      <gender>la</gender>
      <article>la</article>
      <look>Examinas la roca y te das cuenta de que es esférica. Te recuerda a la de Indiana Jones, en no sé qué templo...</look>
      <takemsg>Es muy pesada. No puedes cogerla. Pero eso, ya lo sabías. ¿A que sí?</takemsg>
      <alt>peñasco; pedrusco</alt>
      <touch>Tocas la roca. Es consistente, como tu estómago.</touch>
      <mover>¿Cómo quieres moverla? Tendrás que "esforzarte" un poco más...</mover>
      <golpear>Será mejor que la empujes, a base de golpes no vas a conseguir nada.</golpear>
      <alias>roca</alias>
      <empujar type="script">
        if (ListContains(ScopeVisible(), roca)) {
          msg ("Empujas la roca con un tremendo esfuerzo. Debido a que es esférica, y que hay una pequeña inclinación en el terreno, consigues hacerla rodar hasta la localidad que se encuentra al noroeste.")
          MoveObject (roca, LIMBO)
          MoveObject (roca1, cornisa1)
        }
        else {
          msg ("No puedes empujar la roca. Porque aquí no hay ninguna roca que empujar. Listill@.")
        }
      </empujar>
      <useon type="scriptdictionary">
        <item key="espada">
          msg ("Das unos golpes con la espada sobre la roca. Solo consigues unos sonidos metálicos.")
        </item>
        <item key="casco">
          msg ("Das unos golpes con el casco sobre la roca. Solo consigues unos sonidos metálicos.")
        </item>
      </useon>
    </object>
    <exit alias="este" to="acantilado">
      <inherit name="compassdirection" />
      <inherit name="eastdirection" />
    </exit>
    <exit alias="noroeste" to="cornisa1">
      <inherit name="compassdirection" />
      <inherit name="northwestdirection" />
    </exit>
    <object name="mar1">
      <scenery />
      <look>Su inmensidad te produce sensación de tranquilidad y bienestar. El olor a mar siempre te ha atraído. (No tanto como el olor femenino, pero casi..)</look>
      <oler>Desde aquí hueles el mar. Su olor es característico: salitre, una mezcla de arena mojada, sal y pescado (fresco), y últimamente estás oliendo también una brisa fresca que te hace sentirte muy bien, y respirar a pleno pulmón crema de sol, esterillas, y sardinas asadas.</oler>
      <alias>mar</alias>
    </object>
    <object name="playa1">
      <scenery />
      <look>La playa de finísima arena que ves bajo los acantilados se extiende varios kilómetros.</look>
      <alt>costa</alt>
      <gender>la</gender>
      <article>la</article>
      <alias>playa</alias>
    </object>
    <object name="viento1">
      <scenery />
      <look>Al viento de esta zona,se ve que le va el sadomasoquismo, porque ¡¡¡ te está "azotando" en la cara !!!</look>
      <alias>viento</alias>
    </object>
    <object name="vistaacantilado1">
      <alias>acantilado</alias>
      <scenery />
      <look>La visión desde este acantilado es magnífica.</look>
    </object>
    <object name="gaviota">
      <scenery />
      <look>La gaviota ya se ha alejado, pero presientes que vuestros destinos se volverán a encontrar más adelante... ;)</look>
      <gender>la</gender>
      <article>la</article>
      <alias>gaviota</alias>
    </object>
    <object name="hierba14">
      <inherit name="female" />
      <gender>la</gender>
      <article>la</article>
      <usedefaultprefix type="boolean">false</usedefaultprefix>
      <scenery />
      <look>Simple hierba. Buena para los conejos.</look>
      <alias>hierba</alias>
      <cortar>No vas a necesitar la vegetación cortada para nada.</cortar>
    </object>
  </object>
  <object name="cornisa1">
    <description type="string"></description>
    <picture>acantilado3.jpg</picture>
    <usedefaultprefix type="boolean">false</usedefaultprefix>
    <alias>acantilado</alias>
    <prefix>un</prefix>
    <firstenter type="script">
      msg ("Has llegado al extremo del acantilado. Al norte todo lo que ves es mar. El inmenso mar. Debajo entre una neblina al oeste, pareces distinguir unas piedras planas de color blanco. No sabes lo que son, pero crees tener una idea ... ")
      play sound ("Costa2.mp3", false, false)
    </firstenter>
    <exit alias="sureste" to="cornisa">
      <inherit name="compassdirection" />
      <inherit name="southeastdirection" />
    </exit>
    <object name="mar2">
      <scenery />
      <look>Su inmensidad te produce sensación de tranquilidad y bienestar. El olor a mar siempre te ha atraído. (No tanto como el olor femenino, pero casi..)</look>
      <oler>Desde aquí hueles el mar. Su olor es característico: salitre, una mezcla de arena mojada, sal y pescado (fresco), y últimamente estás oliendo también una brisa fresca que te hace sentirte muy bien, y respirar a pleno pulmón crema de sol, esterillas, y sardinas asadas.</oler>
      <alias>mar</alias>
    </object>
    <object name="playa2">
      <scenery />
      <look>La playa de finísima arena que ves bajo los acantilados se extiende varios kilómetros.</look>
      <alt>costa</alt>
      <gender>la</gender>
      <article>la</article>
      <alias>playa</alias>
    </object>
    <object name="viento2">
      <scenery />
      <look>Al viento de esta zona,se ve que le va el sadomasoquismo, porque ¡¡¡ te está "azotando"en la cara !!!</look>
      <alias>viento</alias>
    </object>
    <object name="vistaacantilado2">
      <alias>acantilado</alias>
      <scenery />
      <look>La visión desde este acantilado es magnífica.</look>
    </object>
    <object name="piedras">
      <scenery />
      <look>Desde aquí no las distingues muy bien. Parecen rectangulares.</look>
      <gender>las</gender>
      <article>las</article>
      <alias>piedras</alias>
    </object>
    <object name="neblina">
      <scenery />
      <look>La neblina no te permite tener una visión muy nítida de las piedras rectangulares.</look>
      <gender>la</gender>
      <article>la</article>
      <alias>neblina</alias>
    </object>
    <object name="hierba15">
      <inherit name="female" />
      <gender>la</gender>
      <article>la</article>
      <usedefaultprefix type="boolean">false</usedefaultprefix>
      <scenery />
      <look>Simple hierba. Buena para los conejos.</look>
      <alias>hierba</alias>
    </object>
  </object>
  <object name="Playa">
    <description type="string"></description>
    <usedefaultprefix type="boolean">false</usedefaultprefix>
    <alias>playa paradisíaca</alias>
    <prefix>una</prefix>
    <enter type="script"><![CDATA[
      msg ("Contemplando una vista maravillosa. <br/><br/>No ves a nadie, pero en tu cabeza suena una dulce melodía. Con una sonrisa en los labios, piensas que la bella ninfa Nerea te susurra una canción, agradeciéndote tu ayuda. <br/><br/>Pronto te encontrarás con el dios RAR. No olvides recordar el nombre de su amado ... <br/><br/>FELICIDADES HAS TERMINADO NEARCO 2. <br/><br/>")
      msg ("Pulsa una tecla")
      WaitForKeyPress
      ClearScreen
      msg ("Agradecimientos:<br/><br/>A POMPONIO, como principal betatester.<br/>A ALEX WARREN, por hacer el pedazo programa que es QUEST 5.0<br/>A ELAINE MARLEY y a NINES, por su apoyo.<br/>Al MEC, por poder descargar desde allí algunos recursos sonoros, posteriormente modificados.<br/>A la WWW, por poder permitirme descargar algunos gráficos que posteriormente han sido modificados para la aventura.<br/>A tí, por jugar esta aventura.<br/>A mí, por disfrutar haciéndola para tí.<br/><br/>Cualquier duda, sugerencia, o lo que quieras decirme: Bolumbero@hotmail.com<br/>Fdo: Jhames.")
      play sound ("cantoninfa.mp3", true, false)
      finish
    ]]></enter>
    <beforefirstenter type="script">
      ClearScreen
      SetBackgroundColour ("White")
      SetForegroundColour ("Black")
      SetFramePicture ("puestasol.jpg")
    </beforefirstenter>
  </object>
  <object name="Aries">
    <description type="string"></description>
    <picture>aries.gif</picture>
    <alias>la casa de Aries</alias>
    <usedefaultprefix type="boolean">false</usedefaultprefix>
    <firstenter type="script">
      msg ("Más cuernos. Recuerdas más esposas. También recuerdas más maridos, aunque jamás los hayas conocido. ")
    </firstenter>
    <enter type="script"><![CDATA[
      play sound ("Grillos nocturnos.mp3", false, false)
      if (craneo.examinado = true) {
        if (ninfa.pillada = false) {
          ClearScreen
          MoveObject (ninfa, Aries)
          msg ("Al llegar a esta constelación zodiacal... escuchas unos jadeos... ¿Qué raro?<br/>")
          play sound ("ninfa.mp3", false, false)
          msg ("Pulsa una tecla ...")
          WaitForKeyPress
          msg ("Luego ves como un fauno se viste a toda prisa, y sale corriendo perdiéndose entre las ramas del bosque...<br/>")
          msg ("Pulsa una tecla ...")
          WaitForKeyPress
          msg ("Inmediatamente después, aparece la ninfa arreglándose el pelo de detrás de unos arbustos. Se sube el escote y se estira de la falda hacia abajo, dándole golpecitos con la palma de la mano, para alisarla y limpiar los restos de broza del bosque que aún permanecen en ella.<br/>Tú le dices: ")
          SetForegroundColour ("Yellow")
          msg ("\"Pero... ¿No estabas de luto por la muerte de tu amado?\"")
          SetForegroundColour ("White")
          msg ("Ella te contesta:")
          SetForegroundColour ("Pink")
          msg ("\"Si... pero la vida del bosque es muy triste. ¡¡¡ Todo el pu...ñetero día mirando estrellas!!! <br/>Una tiene sus necesidades... y los faunos son tan picarones. <br/>Ayyy...!!! (Suspirando).\"")
          SetForegroundColour ("White")
          msg ("Luego continúa diciendo:")
          msg ("Pulsa una tecla ...")
          WaitForKeyPress
          SetForegroundColour ("Pink")
          msg ("Bueno. Dime Nearco, ¿sabrías decirme ya el nombre de mi amado?")
          SetForegroundColour ("White")
          ninfa.pillada = true
        }
      }
      else {
      }
    ]]></enter>
    <exit name="OestePiscis" alias="oeste" to="Piscis">
      <inherit name="compassdirection" />
    </exit>
    <exit name="EsteTauro" alias="este" to="Tauro">
      <inherit name="compassdirection" />
    </exit>
    <exit name="HaciaLaPlaya" alias="norte" to="Playa">
      <inherit name="compassdirection" />
      <inherit name="northdirection" />
      <locked />
      <lockmessage>Da la impresión de que hay un camino detrás de los árboles, pero al estar tan juntos, te impiden el paso.</lockmessage>
    </exit>
    <object name="estrella11">
      <inherit name="plural" />
      <scenery />
      <gender>las</gender>
      <article>las</article>
      <alias>estrellas</alias>
      <alt>estrella; firmamento; cielo</alt>
      <look>Las estrellas brillan de una forma muy peculiar. El agradable olor a galán de noche, y su mera contemplación hacen que te sientas bien contigo mismo.</look>
    </object>
    <object name="paso">
      <scenery />
      <alias>paso</alias>
      <look>Los árboles están tan juntos que te impiden el paso.</look>
      <alt>árbol; arbol; árboles; arboles</alt>
    </object>
  </object>
  <command>
    <pattern>si;sí</pattern>
    <script>
      if (ListContains(ScopeVisible(), ninfa)) {
      }
      else if (ListContains(ScopeVisible(), Viejo)) {
        msg ("El anciano te dice:")
        SetForegroundColour ("Blue")
        msg ("\"Pues venga. Date prisa. Dímelo. ¿Qué es?¿Dime la solución?\"")
        SetForegroundColour ("Black")
      }
      else {
        msg ("Dices \"Sí\", (alqo que juraste no volver a decir desde que te divorciaste de Prusenila), pero solo escuchas el eco de tu propia voz.")
      }
      if (player.parent = sitiodelaninfa) {
        if (ListContains(ScopeVisible(), ninfa)) {
          msg ("La ninfa te dice:")
          SetForegroundColour ("Blue")
          msg ("\"Entra en el laberinto de la estrellas, busca la natividad del hijo de Zeus y Olimpia, y pronuncia mi nombre: \"Nerea\" junto al año en que vio la luz del Sol. Si lo haces correctamente podrás encontrar el nombre de mi amado, y yo podré reunirme con él. Así, podrás seguir con tu destino. ¡¡¡ Que la gloria de Aquiles te acompañe!!!\"")
          SetForegroundColour ("Black")
          play sound ("ninfaseva.mp3", false, false)
          msg ("Como por arte de magia, mientras la ninfa se desvanece, un pasillo se abre entre la vegetación, permitiéndote ir hacia el norte.")
          create exit ("norte", sitiodelaninfa, Pasadizo_horoscopo)
          MoveObject (ninfa, LIMBO)
          ninfa.contestada = true
          SetFramePicture ("sitiodelaninfa.jpg")
        }
      }
      else {
      }
    </script>
  </command>
  <command name="Ner">
    <pattern>Nerea 356;Nerea356</pattern>
    <script><![CDATA[
      if (player.parent = Cancer) {
        if (Cancer.nerea356 = false) {
          msg ("Un sonido atronador suena desde el cielo.<br/>Una voz profunda y varonil como la de Jhames, dice:")
          SetForegroundColour ("Yellow")
          msg ("\"Soy Zeus. Estaba retozando con Afrodita. ¿Eres tú Nearco? Toma esto, y no des más por ...  saco. <br/>Ahora, sigue tu camino\".")
          SetForegroundColour ("White")
          msg ("Un pergamino cae del cielo meciéndose en la brisa de la noche hasta posarse suavemente en el suelo.")
          play sound ("trueno.mp3", false, false)
          MoveObject (numero, Cancer)
          Cancer.nerea356 = true
        }
        else {
          msg ("Ya has molestado a Zeus con esa frase. No sigas insistiendo.")
        }
      }
      else {
        msg ("No estás en la localidad adecuada para decir esa frase.")
      }
    ]]></script>
  </command>
  <object name="Pasadizo_horoscopo1">
    <description>Este es un sitio muy extraño, parece como si la noche se hiciese día, y el día se hiciese noche. </description>
    <alias>un largo corredor del bosque</alias>
    <usedefaultprefix type="boolean">false</usedefaultprefix>
    <picture>DeNegroABlanco.jpg</picture>
    <firstenter type="script">
      play sound ("PasadizoHoroscopo.mp3", false, false)
    </firstenter>
    <exit alias="norte">
      <inherit name="northdirection" />
      <script type="script">
        ClearScreen
        SetBackgroundColour ("Black")
        SetForegroundColour ("White")
        SetFramePicture ("deBlancoANegro.jpg")
        msg ("Mientras avanzas, un manto de oscuridad se cierne sobre ti. Se hace de noche, y en el firmamento ves brillar la estrellas.")
        MoveObject (player, Libra)
      </script>
    </exit>
    <exit alias="sur">
      <inherit name="northdirection" />
      <script type="script">
        ClearScreen
        SetBackgroundColour ("White")
        SetForegroundColour ("Black")
        SetFramePicture ("DeNegroABlanco.jpg")
        msg ("Mientras avanzas, la luz del sol se va apoderando de las tinieblas de la noche...")
        MoveObject (player, sitiodelaninfa)
      </script>
    </exit>
  </object>
  <object name="LIMBO">
    <object name="losa1">
      <usedefaultprefix type="boolean">false</usedefaultprefix>
      <prefix>una</prefix>
      <gender>la</gender>
      <look>Es la losa que estaba encima de la tumba. La roca del acantilado ha caído sobre ella, y la ha hecho añicos...</look>
      <alias>losa</alias>
      <takemsg>Incluso hecha añicos, la losa es demasiado pesada para llevartela</takemsg>
      <touch>Fría. Como la losa de un cementerio.</touch>
      <romper>Ya está rota. No necesitas romperla otra vez.</romper>
      <article>la</article>
      <useon type="scriptdictionary">
        <item key="espada">
          msg ("Aprovechas unos momentitos que tienes, en los que no sabes que hacer, para afilar la espada contra la losa.")
        </item>
        <item key="casco">
          msg ("Golpeas el casco contra la losa, consiguiendo abollarlo un poquito más.")
        </item>
        <item key="numero">
          msg ("Sacas brillo a la losa con el pergamino. Que contenta se va a poner la viuda del difunto cuando vea lo reluciente que está la losa.")
        </item>
      </useon>
    </object>
    <object name="tumba1">
      <usedefaultprefix type="boolean">false</usedefaultprefix>
      <prefix>una</prefix>
      <gender>la</gender>
      <article>la</article>
      <alias>tumba</alias>
      <listchildren type="boolean">false</listchildren>
      <listchildrenprefix>Contiene</listchildrenprefix>
      <isopen />
      <hidechildren />
      <abrir>La tumba ya está abierta.</abrir>
      <takemsg>La tumba es muy pesada. No puedes cogerla. Ni siguiera moverla.</takemsg>
      <examinada type="boolean">false</examinada>
      <touch>Fría. Como la tumba de un cementerio.</touch>
      <look type="script">
        if (tumba1.examinada = false) {
          msg ("Es una tumba. La pesada losa que estaba encima, ahora está hecha pedazos debido a la enorme roca que ha caído sobre ella. La tumba está abierta. Dentro hay un cráneo.")
          SetFramePicture ("craneo.gif")
          play sound ("craneo.mp3", true, false)
          SetFramePicture ("cementerio.jpg")
          MoveObject (craneo, cementerio1)
          tumba1.examinada = true
        }
        else {
          msg ("Es una tumba. La pesada losa que estaba encima, ahora está hecha pedazos debido a la enorme roca que ha caido sobre ella. La tumba está abierta. Dentro hay un cráneo.")
        }
      </look>
      <useon type="scriptdictionary">
        <item key="espada">
          msg ("Escarbas un poquito con la punta de la espada dentro de la tumba, pero no ves nada interesante.")
        </item>
        <item key="casco">
          msg ("Golpeas el casco contra la tumba. Al cabo de un rato, te detienes miras el casco y ves que está abollado.")
        </item>
        <item key="numero">
          msg ("No conseguirás nada enterrando el pergamino.")
        </item>
      </useon>
    </object>
    <object name="roca2">
      <usedefaultprefix type="boolean">false</usedefaultprefix>
      <prefix>una</prefix>
      <gender>la</gender>
      <article>la</article>
      <alias>roca</alias>
      <look>Examinas la roca y te das cuenta de que es esférica. Te recuerda a la de Indiana Jones. La roca ha caido sobre la losa de la tumba y la ha hecho pedazos. Ha quedado encajada entre varias piedras y no se puede mover.</look>
      <empujar>La roca ha quedado encajada entre los restos de la losa partida en varios trozos, y no se puede mover.</empujar>
      <alt>peñasco; pedrusco</alt>
      <takemsg>Es muy pesada. No puedes cogerla. Pero eso, ya lo sabías. ¿A que sí?</takemsg>
      <touch>Tocas la roca. Es consistente, como tu estómago.</touch>
      <mueve>Está encajada entre los restos de la losa. No puedes moverla. Mucho menos empujarla. Bueno si puedes, pero no consigues nada, solamente cansarte un poco.</mueve>
      <useon type="scriptdictionary">
        <item key="casco">
          msg ("Das unos golpes con la espada sobre la roca. Solo consigues unos sonidos metálicos.")
        </item>
        <item key="espada">
          msg ("Das unos golpes con la espada sobre la roca. Solo consigues unos sonidos metálicos.")
        </item>
      </useon>
    </object>
    <object name="roca1">
      <usedefaultprefix type="boolean">false</usedefaultprefix>
      <prefix>una</prefix>
      <gender>la</gender>
      <article>la</article>
      <alias>roca</alias>
      <look><![CDATA[Es la roca que has arrastrado rodando hasta aquí. <br/>Es esférica, y no muy pesada, por lo que, haciéndola rodar, la puedes mover con cierto esfuerzo.]]></look>
      <alt>peñasco; pedrusco</alt>
      <takemsg>Es muy pesada. No puedes cogerla. Pero eso, ya lo sabías. ¿A que sí?</takemsg>
      <touch>Tocas la roca. Es consistente, como tu estómago.</touch>
      <mover>¿Cómo quieres moverla? Tendrás que "esforzarte" un poco más...</mover>
      <golpear>Será mejor que la empujes, a base de golpes no vas a conseguir nada.</golpear>
      <empujar type="script">
        msg ("Empujas la roca con un tremendo esfuerzo. Debido a que es esférica y hay una pequeña inclinación en el terreno, consigues hacerla rodar hasta el extremo del acantilado, donde se precipita en el vacio ...")
        Pause (1)
        msg ("Al cabo de unos segundos, oyes un fuerte estruendo...")
        play sound ("caida.mp3", false, false)
        MoveObject (roca1, LIMBO)
        MoveObject (tumba, LIMBO)
        MoveObject (losa, LIMBO)
        MoveObject (losa1, cementerio1)
        MoveObject (tumba1, cementerio1)
        MoveObject (roca2, cementerio1)
        MoveObject (piedras, LIMBO)
        MoveObject (piedras1, cornisa1)
      </empujar>
      <useon type="scriptdictionary">
        <item key="casco">
          msg ("Das unos golpes con la espada sobre la roca. Solo consigues unos sonidos metálicos.")
        </item>
        <item key="espada">
          msg ("Das unos golpes con la espada sobre la roca. Solo consigues unos sonidos metálicos.")
        </item>
      </useon>
    </object>
    <object name="craneo">
      <usedefaultprefix type="boolean">false</usedefaultprefix>
      <prefix>un</prefix>
      <alt>craneo</alt>
      <takemsg>Por muy valiente que seas, y mucho general de Alejandro Magno, jamás te atreverías a llevar un cráneo contigo. Es de mal fario.</takemsg>
      <alias>cráneo</alias>
      <examinado type="boolean">false</examinado>
      <touch>Metes los dos dedos por la parte de atrás de los ojos, metiendo la mano por debajo del mentón. Luego te pones el cráneo delante de tí. Lo miras fíjamente a los ojos, y te partes el culo de la risa, cuando mueves aleatoriamente los dedos. Cansado de reírte, vuelves a dejar el cráneo en su sitio para que descanse en paz, que fue la intención original de los que enterraron al difunto, y que por lo visto no han tenido mucho éxito.</touch>
      <XI>En la imagen aparece un cráneo con una serie de números del uno al seis colocados encima de los huesos. En la parte de abajo del gráfico, a la izquierda se ve 2=5. Necesitará un poquito de ayuda externa para poder resolver este puzzle.</XI>
      <look type="script"><![CDATA[
        msg ("Es un cráneo. No sabes si humano. Pero si que pertenecía a la cabeza de alguien.")
        msg ("Tiene unas extrañas inscripciones.<br/>")
        picture ("craneo.jpg")
        craneo.examinado = true
      ]]></look>
      <useon type="scriptdictionary">
        <item key="espada">
          msg ("Metes la espada por un ojo del cráneo. Te hace gracia como queda. Te ríes, y vuelves a sacar la espada ...")
        </item>
        <item key="casco">
          msg ("Le pones el casco al cráneo. Lo miras, y te pegas un \"jartá\"de reir. Luego, te lo vuelves a poner.")
        </item>
        <item key="numero">
          msg ("Metes el pergamino por un ojo del cráneo y lo sacas por el otro .Te hace una gracia que te partes de la risa. Luego lo sacas...")
        </item>
      </useon>
    </object>
    <object name="ninfa">
      <usedefaultprefix type="boolean">false</usedefaultprefix>
      <gender>la</gender>
      <article>la</article>
      <prefix>una</prefix>
      <alias>ninfa</alias>
      <alt>Nerea</alt>
      <takemsg>A ver. Piensa. Coges a la ninfa. Te la llevas en brazos. Te pilla tu mujer, y entonces dime.. ¿Qué cuento le cuentas...? Seguro que te pide el divorcio. No merece la pena. Te lo aseguro.</takemsg>
      <displayverbs>Examinar; Coger</displayverbs>
      <contestada type="boolean">false</contestada>
      <kiss>Ufff... eso te costaría el salario de dos años de duros combates. Y aunque merece la pena, seguro que tendrás ocasión de hacerlo gratis, algo más tarde...</kiss>
      <empujar>Pobrecilla. Ni se te ocurra.</empujar>
      <hit>Pobrecilla. ¡¡¡ Ni se te ocurra !!!</hit>
      <kill>Sí. Estoy seguro de que la matarías. Pero como a las cucarachas... ¡¡¡ A polvos !!!</kill>
      <lick>Más quisieras... </lick>
      <mover>Nop. No se mueve del sitio.</mover>
      <smell>Huele a......... como te diría yo............Ninfas del bosque.</smell>
      <touch>No. Seguro que te diría eso de "Se mira, pero no se toca, guapo".</touch>
      <ayudar>Venga... date prisa. Ayúdala.</ayudar>
      <pillada type="boolean">false</pillada>
      <look type="script"><![CDATA[
        SetFramePicture ("ninfa.jpg")
        msg ("¡¡¡ Es un pedazo de ninfa del quince !!!<br/>Seguro que ha sido portada del Playboy Griego del mes de enero del año 332 A.de C.<br/>Si fueses un fauno.. estoy seguro de que no se te escapaba.<br/>Parece triste.")
      ]]></look>
      <telldefault type="script">
        if (player.parent = sitiodelaninfa) {
          msg ("La ninfa dice:")
          SetForegroundColour ("Purple")
          msg ("\"Uffff.. Nearco. No sé de que me hablas...\"")
          SetForegroundColour ("Black")
        }
        else {
          msg ("La ninfa dice:")
          SetForegroundColour ("Blue")
          msg ("\"Uffff.. Nearco. No sé de que me hablas...\"")
          SetForegroundColour ("White")
        }
      </telldefault>
      <tell type="scriptdictionary">
        <item key="hola buenas buenos días buenos dias buenas tardes">
          if (player.parent = sitiodelaninfa) {
            msg ("La ninfa dice:")
            SetForegroundColour ("Blue")
            msg ("\"Hola Nearco. Estoy segura de que los dioses te han enviado para ayudarme ...\"")
            SetForegroundColour ("Black")
          }
          else {
            msg ("La ninfa dice:")
            SetForegroundColour ("Pink")
            msg ("\"Hola Nearco. Volvemos a encontrarnos ...\"")
            SetForegroundColour ("White")
          }
        </item>
        <item key="nombre llamas">
          if (player.parent = sitiodelaninfa) {
            msg ("La ninfa dice:")
            SetForegroundColour ("Blue")
            msg ("\"Me llamo Nerea. Ninfa de estos bosques.\"")
            SetForegroundColour ("Black")
          }
          else {
            msg ("La ninfa dice:")
            SetForegroundColour ("Pink")
            msg ("\"Me llamo Nerea. Ninfa de estos bosques.\"")
            SetForegroundColour ("White")
          }
        </item>
        <item key="viejo anciano matemático matematico Piruletias">
          if (player.parent = sitiodelaninfa) {
            msg ("La ninfa dice:")
            SetForegroundColour ("Blue")
            msg ("\"En tiempos fue mi amante. Me lo dejé porque siempre estaba absorto en las matemáticas. No sabía satisfacer a una ninfa del bosque como se merece. Aún así, guardo buenos recuerdos de él.\"")
            SetForegroundColour ("Black")
          }
          else {
            msg ("La ninfa dice:")
            SetForegroundColour ("Pink")
            msg ("\"En tiempos fue mi amante. Me lo dejé porque siempre estaba absorto en las matemáticas. No sabía satisfacer a una ninfa del bosque como se merece. Aún así, guardo buenos recuerdos de él.\"")
            SetForegroundColour ("White")
          }
        </item>
        <item key="cementerio">
          if (player.parent = sitiodelaninfa) {
            msg ("La ninfa dice:")
            SetForegroundColour ("Blue")
            msg ("\"Allí es donde está enterrado mi amado\"")
            SetForegroundColour ("Black")
          }
          else {
            msg ("La ninfa dice:")
            SetForegroundColour ("Pink")
            msg ("\"Allí es donde está enterrado mi amado\"")
            SetForegroundColour ("White")
          }
        </item>
        <item key="pergamino número numero números numeros">
          if (player.parent = sitiodelaninfa) {
            msg ("La ninfa dice:")
            SetForegroundColour ("Blue")
            msg ("\"Uffff.. yo no tengo ni idea de eso. No tuve estudios. Cuando era niña mi madre de nombre \"Mana\" me llevo aprender costura para hacerle los vestidos a los faunos del bosque .\"")
            SetForegroundColour ("Black")
          }
          else {
            msg ("La ninfa dice:")
            SetForegroundColour ("Pink")
            msg ("\"Uffff.. yo no tengo ni idea de eso. No tuve estudios. Cuando era niña mi madre de nombre \"Mana\" me llevo aprender costura para hacerle los vestidos a los faunos del bosque .\"")
            SetForegroundColour ("White")
          }
        </item>
        <item key="craneo cráneo">
          if (player.parent = sitiodelaninfa) {
            msg ("La ninfa dice:")
            SetForegroundColour ("Blue")
            msg ("\"Me gustaba más cuando tenía carne.. y pelo\"")
            SetForegroundColour ("Black")
          }
          else {
            msg ("La ninfa dice:")
            SetForegroundColour ("Pink")
            msg ("\"Me gustaba más cuando tenía carne.. y pelo\"")
            SetForegroundColour ("White")
          }
        </item>
        <item key="si sí claro ok">
          if (player.parent = sitiodelaninfa) {
            msg ("La ninfa te dice:")
            SetForegroundColour ("Blue")
            msg ("\"Entra en el laberinto de la estrellas, busca la natividad del hijo de Zeus y Olimpia, y pronuncia mi nombre: \"Nerea\" junto al año en que vio la luz del Sol. Si lo haces correctamente podrás encontrar el nombre de mi amado, y yo podré reunirme con él. Así, podrás seguir con tu destino. ¡¡¡ Que la gloria de Aquiles te acompañe!!!\"")
            SetForegroundColour ("Black")
            play sound ("ninfaseva.mp3", false, false)
            msg ("Como por arte de magia, mientras la ninfa se desvanece, un pasillo se abre entre la vegetación, permitiéndote ir hacia el norte.")
            create exit ("norte", sitiodelaninfa, Pasadizo_horoscopo)
            MoveObject (ninfa, LIMBO)
            ninfa.contestada = true
            SetFramePicture ("sitiodelaninfa.jpg")
          }
          else {
            msg ("La ninfa te dice:")
            SetForegroundColour ("Pink")
            msg ("\"Venga, dímelo...\"")
            SetForegroundColour ("White")
          }
        </item>
        <item key="amado querido amante amor novio">
          if (player.parent = sitiodelaninfa) {
            msg ("La ninfa dice:")
            SetForegroundColour ("Blue")
            msg ("\"Murió. Y ahora está enterrado en el cementerio.\"")
            SetForegroundColour ("Black")
          }
          else {
            msg ("La ninfa dice:")
            SetForegroundColour ("Pink")
            msg ("\"Murió. Y ahora está enterrado en el cementerio.\"")
            SetForegroundColour ("White")
          }
        </item>
        <item key="hoguera fuego fogata">
          if (player.parent = sitiodelaninfa) {
            msg ("La ninfa dice:")
            SetForegroundColour ("Blue")
            msg ("\"Creo que el anciano del bosque siempre tiene una encendida.\"")
            SetForegroundColour ("Black")
          }
          else {
            msg ("La ninfa dice:")
            SetForegroundColour ("Pink")
            msg ("\"Creo que el anciano del bosque siempre tiene una encendida.\"")
            SetForegroundColour ("White")
          }
        </item>
        <item key="espray spray aerosol antiserpientes rayo">
          if (player.parent = sitiodelaninfa) {
            msg ("La ninfa dice:")
            SetForegroundColour ("Blue")
            msg ("\"¡¡¡ Anda !!! Yo tengo uno igual. Regalo de Zeus. Mi rayo es para depilarme las axilas. Me costó una mam.. digo un montón de esfuerzo, pero valió la pena.\"")
            SetForegroundColour ("Black")
          }
          else {
            msg ("La ninfa dice:")
            SetForegroundColour ("Pink")
            msg ("\"¡¡¡ Anda !!! Yo tengo uno igual. Regalo de Zeus. Mi rayo es para depilarme las axilas. Me costó una mam.. digo un montón de esfuerzo, pero valió la pena.\"")
            SetForegroundColour ("White")
          }
        </item>
        <item key="fauno faunos">
          if (player.parent = sitiodelaninfa) {
            msg ("La ninfa dice:")
            SetForegroundColour ("Blue")
            msg ("\"Me chiflan. Algunos están buenísimos.\"")
            SetForegroundColour ("Black")
          }
          else {
            msg ("La ninfa dice:")
            SetForegroundColour ("Pink")
            msg ("\"Me chiflan. Algunos están buenísimos.\"")
            SetForegroundColour ("White")
          }
        </item>
        <item key="follar folla casquete polvo mamada chupada chupar">
          if (player.parent = sitiodelaninfa) {
            msg ("La ninfa dice:")
            SetForegroundColour ("Blue")
            msg ("\"Uyyy... Nearco ¡¡¡ Que atrevido !!! Pásate esta noche por el Ninfa's Club, y hablamos.\"")
            SetForegroundColour ("Black")
          }
          else {
            msg ("La ninfa dice:")
            SetForegroundColour ("Pink")
            msg ("\"Uyyy... Nearco ¡¡¡ Que atrevido !!! Pásate por aquí esta noche y hablamos.\"")
            SetForegroundColour ("White")
          }
        </item>
        <item key="serpiente">
          if (player.parent = sitiodelaninfa) {
            msg ("Lo siento Nearco. No sé que decirte. Solamente los dioses pueden ayudarte...")
          }
          else {
            msg ("Vaya Nearco, veo que conseguiste deshacerte de la serpiente. Felicidades.")
          }
        </item>
        <item key="no">
          if (player.parent = sitiodelaninfa) {
            msg ("La ninfa dice:")
            SetForegroundColour ("Blue")
            msg ("\"Como quieras Nearco. Pero así, nunca podrás terminar esta aventura.\"")
            SetForegroundColour ("Black")
          }
          else {
            msg ("La ninfa dice:")
            SetForegroundColour ("Pink")
            msg ("\"Como quieras Nearco. Pero así, nunca podrás terminar esta aventura.\"")
            SetForegroundColour ("White")
          }
        </item>
        <item key="roca rocas">
          if (player.parent = sitiodelaninfa) {
            msg ("La ninfa dice:")
            SetForegroundColour ("Blue")
            msg ("\"Busca por los acantilados. Por allí, siempre suele haber alguna de gran tamaño.\"")
            SetForegroundColour ("Black")
          }
          else {
            msg ("La ninfa dice:")
            SetForegroundColour ("Pink")
            msg ("\"Busca por los acantilados. Por allí, siempre suele haber alguna de gran tamaño.\"")
            SetForegroundColour ("White")
          }
        </item>
        <item key="pajaro pájaro pájaros pajaros pajarillos">
          if (player.parent = sitiodelaninfa) {
            msg ("La ninfa dice:")
            SetForegroundColour ("Blue")
            msg ("\"Pobrecillos. Que gordos están. Me dan una pena...\"")
            SetForegroundColour ("Black")
          }
          else {
            msg ("La ninfa dice:")
            SetForegroundColour ("Pink")
            msg ("\"Pobrecillos. Que gordos están. Me dan una pena...\"")
            SetForegroundColour ("White")
          }
        </item>
        <item key="ayuda ayudar">
          if (player.parent = sitiodelaninfa) {
            msg ("La ninfa dice:")
            SetForegroundColour ("Blue")
            msg ("\"Vale. Regálame un pisito en Atenas y me habrás ayudado bastante.\"")
            SetForegroundColour ("Black")
          }
          else {
            msg ("La ninfa dice:")
            SetForegroundColour ("Pink")
            msg ("\"Vale. Regálame un pisito en Atenas y me habrás ayudado bastante.\"")
            SetForegroundColour ("White")
          }
        </item>
        <item key="jhames">
          if (player.parent = sitiodelaninfa) {
            msg ("La ninfa dice:")
            SetForegroundColour ("Blue")
            msg ("\"Jo. Que guapo es. Y además, listo. El día que lo pille, se va a enterar de como trabaja una Ninfa de verdad. Dicen por ahí que dentro de dos mil años se seguirá hablando de sus aventuras. Y la verdad, yo me lo creo.\"")
            SetForegroundColour ("Black")
          }
          else {
            msg ("La ninfa dice:")
            SetForegroundColour ("Pink")
            msg ("\"Jo. Que guapo es. Y además, listo. El día que lo pille, se va a enterar de como trabaja una Ninfa de verdad. Dicen por ahí que dentro de dos mil años se seguirá hablando de sus aventuras. Y la verdad, yo me lo creo.\"")
            SetForegroundColour ("White")
          }
        </item>
        <item key="teofet">
          if (Contains (Aries,ninfa)) {
            SetForegroundColour ("White")
            msg ("La ninfa te mira, te da un beso (con lengua) y te dice:")
            SetForegroundColour ("Pink")
            msg ("\"Gracias. No sé cómo podré agradecértelo. Quizás algún día...Ahora que sé que su nombre era TEOFET, por fin podré reunirme con mi amado. Sigue tu destino, lo encontrarás al norte ... Cuando te visite el dios RAR no olvides decirle como se llamaba mi gran amor. Adiós Nearco. Que la sabiduría de Artemisa ilumine tu camino...\"")
            msg ("Tras decir esto, varios árboles que estaban al norte desaparecen dejándote el paso libre...")
            play sound ("Teofet.mp3", false, false)
            destroy ("OestePiscis")
            destroy ("EsteTauro")
            HaciaLaPlaya.locked = false
          }
          else {
            msg ("Gritas el nombre de Teofet, pero no ocurre nada...")
          }
        </item>
      </tell>
      <useon type="scriptdictionary">
        <item key="espada">
          msg ("¡¡¡ NI SE TE OCURRA !!!  (Con lo buena que está)")
        </item>
        <item key="casco">
          msg ("La ninfa se pone el casco un rato, luego decide que no le sienta bien, y te lo devuelve.")
        </item>
        <item key="numero">
          msg ("La ninfa no sabe leer, y te devuelve el pergamino.")
        </item>
      </useon>
    </object>
    <object name="numero">
      <take />
      <alias>pergamino</alias>
      <usedefaultprefix type="boolean">false</usedefaultprefix>
      <prefix>un</prefix>
      <hidechildren type="boolean">false</hidechildren>
      <alt>números; numero; papel</alt>
      <takemsg>Coges el pergamino que te envió Zeus, y te lo guardas.</takemsg>
      <dropmsg>Cansado de llevar el pergamino, lo dejas.</dropmsg>
      <gender>lo</gender>
      <article>el</article>
      <XI>En la imagen aparece un gráfico que es una rejilla de cuatro filas por cuatro columnas. En la primera fila hay los siguientes números: 1037956284,1036947285,1027856394,1026847395. En la segunda fila: 1026857394,1027846395,aquí falta un número,1037946285. En la tercera fila: 1036847295,1037856294,1026947385,1027956384, y en la cuarta fila: 1027946385,1026857384,1037846295,1036857294.</XI>
      <escribir>Será mejor que le digas el número al anciano.</escribir>
      <look type="script"><![CDATA[
        msg ("Es el pergamino que ha caído del cielo cuando sonó el trueno. Lleva varios números apuntados. Por un momento crees que son los teléfonos de las diosas más viciosillas del Olimpo. Pero luego te das cuenta, con pavor, de que aún no se ha inventado el teléfono.<br/>")
        picture ("numero.jpg")
      ]]></look>
      <quemar type="script">
        msg ("Acercas el pergamino a la hoguera y ves con satisfacción como en el hueco del número que falta van apareciendo unos caracteres. El pergamino te lo han enviado los dioses y es incombustible pero crees distinguir unas palabras que han aparecido con el calor. Con cuidado y sin quemarte, recuperas el pergamino y en el hueco del número que falta lees: “Jhames es un borde”.")
      </quemar>
      <useon type="scriptdictionary">
        <item key="espada">
          msg ("Sería una pena cortar un pergamino que ha sido regalo del mismísimo Zeus. No. Mejor lo conservas tal cual.")
        </item>
        <item key="casco">
          msg ("Le pones el casco al pergamino, pero definitivamente, no le sienta bien.")
        </item>
      </useon>
    </object>
    <object name="serpiente">
      <inherit name="surface" />
      <usedefaultprefix type="boolean">false</usedefaultprefix>
      <alias>serpiente</alias>
      <prefix>una</prefix>
      <gender>la</gender>
      <article>la</article>
      <look>Puaajj... Es asquerosa. No parece muy agresiva. Pero solo lo parece. Su enorme tamaño podría engullirte de un solo bocado.</look>
      <alt>víbola; vibora; áspid; aspid</alt>
      <takemsg>Imposible. Te tragaría en menos tiempo que tú te cargas a cincuenta soldados persas.</takemsg>
      <transparent type="boolean">false</transparent>
      <matar>Hmmmm... No puedes matar a la serpiente. Nearco, creo que únicamente los dioses pueden ayudarte...</matar>
      <pisar>Hmmmm... No puedes pisar a la serpiente. Nearco, ¡¡¡ únicamente los dioses pueden ayudarte !!!</pisar>
      <golpear>Ni se te ocurre. Acercarte demasiado a ella, pondría en peligro tu vida...</golpear>
      <rodear>Ni lo intentes. La serpiente te engulliría como a un conejo en el momento en que te tuviese a una distancia cercana.</rodear>
      <saltar>Ni lo intentes. La serpiente te engulliría como a un conejo en el momento en que te tuviese a una distancia cercana.</saltar>
      <hipnotizar>Intentas hipnotizar a la serpiente... lo intentas. Lo intentas un poco más... después de un ratito, te das cuenta de que lo único que has conseguido ha sido ponerte bizco, y que ahora te duelan los ojos un poquito.</hipnotizar>
      <give>Parece que a la serpiente no le interesa nada de lo que puedas darle.</give>
      <acariciar>Hmmm... estoy seguro de que eso le gustaría. Y también estoy seguro de que después de que la acariciaras, aún le gustaría más tragarte de un solo bocado...</acariciar>
      <kiss>Hmmm... estoy seguro de que eso le gustaría. Y también estoy seguro de que después de que la besaras, aún le gustaría más tragarte de un solo bocado...</kiss>
      <smell>Pues... huele a ... serpiente, serpiente hambrienta, para ser más exactos.</smell>
      <listento>Escuchas a la serpiente decir: "Shhhhhhhhh...", que en su lengua significará seguramente: "Te voy a comeeeerrrrrrr...."</listento>
      <moder>Es ella la que te va a morder a tí, como te acerques demasiado...</moder>
      <telldefault type="script">
        msg ("La serpiente te contesta:")
        SetForegroundColour ("Red")
        msg ("\"Sssssssssssshhhhhhhhhhhhhhhhhhhhhhhhhhhhhh.................\"")
        SetForegroundColour ("Black")
        msg ("Y tú piensas que no debe de ser nada bueno... porque sus intenciones no parecen pacíficas.")
      </telldefault>
      <useon type="scriptdictionary">
        <item key="antiserpientes">
          if (Got(antiserpientes)) {
            if (antiserpientes.lleno = true) {
              msg ("Rocías a la serpiente con el rayo-espray antiserpientes que te regaló Zeus. La serpiente encantada son su sabor empieza a lamerse por todo el cuerpo. Al cabo de unos segundos, le entran unos retortijones de barriga, y sale corriendo despavorida. Ahora tienes el paso libre.")
              MoveObject (serpiente, LIMBO)
              antiserpientes.lleno = false
              Pause (2)
              SetFramePicture ("caminohaciapuente.jpg")
              camino norestenoreste.pasolibre = true
            }
            else {
              msg ("Hmmmm... parece que tu espray antiserpientes está vacío.")
            }
          }
          else {
            msg ("Hmmmm... parece que no llevas el espray antiserpientes.")
          }
        </item>
      </useon>
      <object name="boca">
        <look>La serpiente tiene una lengua sibilina que no para de decir: "Shhhhh... Shhhhh..."</look>
        <scenery />
        <gender>la</gender>
        <article>la</article>
        <alt>lengua</alt>
      </object>
      <object name="ojos">
        <scenery />
        <look>Te miran hambrientos... Ñam... Ñam...</look>
        <mirar>Te miran hambrientos... Ñam... Ñam...</mirar>
      </object>
    </object>
    <object name="antiserpientes">
      <scenery type="boolean">false</scenery>
      <alias>antiserpientes</alias>
      <usedefaultprefix type="boolean">false</usedefaultprefix>
      <prefix>un</prefix>
      <gender>lo</gender>
      <article>el</article>
      <take />
      <lleno />
      <takemsg>Coges el poderosísimo rayo anti-serpientes marca "Zeus and Friends Limited Corporation".</takemsg>
      <dropmsg>Dejas el poderosísimo rayo anti-serpientes marca "Zeus and Friends Limited Corporation".</dropmsg>
      <alt>antiserpientes; anti-serpientes; aerosol; spray; espray; rayo; antiserpiente; anti-serpiente</alt>
      <look type="script"><![CDATA[
        msg ("Es un rayo anti-serpientes que te ha enviado el poderoso Zeus desde los cielos. Parece que no está caducado... <br/>(En realidad es un aerosol anti-serpientes, pero los griegos en aquella época no tenían en su diccionario la palabra espray...) ")
        SetFramePicture ("antiserpientes.jpg")
      ]]></look>
    </object>
    <object name="piedras1">
      <scenery />
      <look>Desde aquí no las distingues muy bien. Parecen rectangulares. Algunas parecen rotas.</look>
      <gender>las</gender>
      <article>las</article>
      <alias>piedras</alias>
    </object>
    <object name="lobo1">
      <scenery />
      <look>El lobo se ha marchado. Ya no eres capaz de verlo, y eso aún te intranquiliza mucho más...</look>
      <alias>lobo</alias>
    </object>
  </object>
  <verb name="Abrir">
    <property>abrir</property>
    <pattern>abrir; abre</pattern>
    <defaultexpression>"No puedes abrir eso"</defaultexpression>
  </verb>
  <verb name="Mover">
    <property>mover</property>
    <pattern>mover;mueve</pattern>
    <defaultexpression>"No puedes mover eso"</defaultexpression>
  </verb>
  <verb name="Empujar">
    <property>empujar</property>
    <pattern>empujar;empuja;tirar;tirar de; tirar de la; empujar la; empujar el; empuja la; empuja el</pattern>
    <defaultexpression>"No puedes empujar eso."</defaultexpression>
  </verb>
  <command name="Teofet">
    <pattern>Teofet;teofet;TEOFET</pattern>
    <script><![CDATA[
      if (Contains (Aries,ninfa)) {
        SetForegroundColour ("White")
        msg ("La ninfa te mira, te da un beso (con lengua) y te dice:")
        SetForegroundColour ("Pink")
        msg ("\"Gracias Nearco. No sé cómo podré agradecértelo. <br/>Quizás algún día...<br/>Ahora que sé que su nombre era TEOFET, por fin podré reunirme con mi amado. ¿No crees que es un nombre precioso?<br/>Sigue tu destino, lo encontrarás al norte ...<br/>Cuando te visite el dios RAR no olvides decirle como se llamaba mi gran amor.<br/>Adiós Nearco. Que la sabiduría de Artemisa ilumine tu camino...\"")
        msg ("Tras decir esto, varios árboles que estaban al norte desaparecen dejándote el paso libre...")
        play sound ("Teofet.mp3", false, false)
        destroy ("OestePiscis")
        destroy ("EsteTauro")
        HaciaLaPlaya.locked = false
      }
      else {
        msg ("Gritas el nombre de Teofet, pero no ocurre nada...")
      }
    ]]></script>
  </command>
  <verb name="Entrar">
    <property>entrar</property>
    <pattern>entrar;entra;pasar;pasa</pattern>
    <defaultexpression>"No puedes entrar ahí"</defaultexpression>
  </verb>
  <verb name="Romper">
    <property>romper</property>
    <pattern>romper; rompe; romper el; rompe el; romper la; rompe la</pattern>
    <defaultexpression>"No puedes romper eso"</defaultexpression>
  </verb>
  <verb name="Poner">
    <property>poner</property>
    <pattern>poner;pon;ponerte;ponte;poner el; pon el;ponerte el;ponte el</pattern>
    <defaultexpression>"No puedes."</defaultexpression>
  </verb>
  <command name="Oler">
    <pattern>oler;huele;aspirar;respirar</pattern>
    <unresolved type="string"></unresolved>
    <script>
      if (player.parent = NorteCaminoNoroesteNoroeste) {
        msg ("Hueles a humo. Simple humo. Nada de tocino a la brasa, ni cosas de esas que tienen colesterol.")
      }
      else {
      }
      if (player.parent = Camino Norte) {
        msg ("El olor del tomillo y el romero impregna tus fosas nasales.")
      }
      else {
        msg ("No hueles nada, excepto el tufillo de tus sobacos.")
      }
    </script>
  </command>
  <verb name="Ayudar">
    <property>ayudar</property>
    <pattern>ayudar;ayuda</pattern>
    <defaultexpression>"No hay ayuda que valga."</defaultexpression>
  </verb>
  <command name="Descansar">
    <pattern>descansar;descansa;reposar;resposa;dormir;duerme</pattern>
    <unresolved type="string"></unresolved>
    <script><![CDATA[
      msg ("Descansas un ratito. Luego, más espabilado, vuelves a la aventura que te espera....<i>(Por cierto, parece que tienes apnea, visita al médico lo antes posible...)</i>")
      play sound ("Descansando.mp3", true, false)
    ]]></script>
  </command>
  <command name="Poner Casco">
    <pattern>Ponerme casco;poner casco;ponerme el casco;poner casco;poner el casco;ponte casco; ponte el casco;ponerte el casco;ponerte casco</pattern>
    <script>
      if (Got(casco)) {
        msg ("Te pones el casco. Estás guapísimo con el casco puesto, porque solamente se te ve la mitad de la cara.")
      }
      else {
        msg ("No llevas el casco. Cógelo primero.")
      }
    </script>
  </command>
  <command name="Quitar casco">
    <pattern>quitarme casco;quitar casco;quitarme el casco;quitar casco;quitar el casco;quitar casco;quita el casco;quitarte el casco;quitarte casco</pattern>
    <script>
      if (Got(casco)) {
        msg ("Te quitas el casco. Ahora lo llevas en la mano.")
      }
      else {
        msg ("No llevas el casco. Cógelo primero.")
      }
    </script>
  </command>
  <command name="Oler romero">
    <pattern>oler romero;oler tomillo;oler vegetación;oler vegetacion;oler plantas;oler arbustos</pattern>
    <script>
      if (player.parent = Camino Norte) {
        msg ("Hmmmm... Huele de maravilla. Como te gustaría hacer una buena paella de patatas, conejo y tomillo. (Bueno, perdona, las patatas son originarias de América, de modo que en esa época, no sé si había en Persia).")
      }
      else {
        msg ("Por aquí huele a romero y tomillo, pero la fragancia es muy suave.")
      }
    </script>
  </command>
  <command name="DECIR ZEUS AYUDA">
    <pattern>decir zeus ayuda</pattern>
    <script>
      if (player.parent = Cancer) {
        msg ("Una voz poderosa responde:")
        SetForegroundColour ("Yellow")
        msg ("Ayuda. ¿En qué?")
        SetForegroundColour ("White")
      }
      else {
        msg ("Aquí Zeus, no te escucha. Parece estar ocupado en otros \"menesteres\"...")
      }
    </script>
  </command>
  <command name="DECIR ZEUS SERPIENTE">
    <pattern>decir zeus serpiente; di zeus serpiente; decir zéus serpiente;di zéus serpiente</pattern>
    <script>
      if (player.parent = Cancer) {
        if (Cancer.spray = false) {
          msg ("Una atronadora voz se escucha desde los cielos:")
          SetForegroundColour ("Yellow")
          msg ("\"Nearco, por Dios te lo pido, digo, por -MÍ- te lo pido, déjame ya en paz.  Ah... ya veo, tienes problemas con la serpiente. Bueno, me has hecho bastantes ofrendas, de modo que toma este rayo anti-serpientes made in Zeus... pero no me des más follón\"")
          SetForegroundColour ("White")
          msg ("De pronto, una especie de bote, tipo spray, cae del cielo y rebota a tus pies varias veces...")
          MoveObject (antiserpientes, Cancer)
          SetForegroundColour ("White")
          play sound ("bote.mp3", false, false)
          Cancer.spray = true
        }
        else {
          msg ("Será mejor que no molestes más a Zeus con la serpiente.")
        }
      }
      else {
        msg ("Aquí Zeus, no te escucha. Parece estar ocupado en otros \"menesteres\"...")
      }
    </script>
  </command>
  <verb name="Huele">
    <property>oler</property>
    <pattern>oler;huele;aspirar;respirar</pattern>
    <defaultexpression>"No huele a nada especial"</defaultexpression>
  </verb>
  <command name="Test">
    <unresolved type="string"></unresolved>
    <pattern>Testiu</pattern>
    <script>
      list = NewStringList()
      list add (list, "Oler")
      list add (list, "Item 2")
      result = ShowMenu ("Test menu", list, false)
    </script>
  </command>
  <command name="Rociar">
    <pattern type="string"><![CDATA[(^rociar|^rocia|^rocía|^salpicar|^salpica|^chispear|^chispea|^salpicar|^salpica|^mojar|^moja|^regar|^riega|^bañar|^baña|^humedecer|^humedece) (?<object>.*) con (espray|spray|rayo|antiserpientes|anti-serpientes|rayo antiserpientes|rayo anti-serpientes|aerosol|antiserpiente)]]></pattern>
    <unresolved>No veo eso.</unresolved>
    <script>
      if (Got(antiserpientes)) {
        if ((object)=serpiente) {
          if (antiserpientes.lleno = true) {
            play sound ("serpienteseva.mp3", false, false)
            msg ("Rocías a la serpiente con el rayo-espray antiserpientes que te regaló Zeus. La serpiente encantada son su sabor empieza a lamerse por todo el cuerpo. Al cabo de unos segundos, le entran unos retortijones de barriga, y sale corriendo despavorida. Ahora tienes el paso libre.")
            MoveObject (serpiente, LIMBO)
            antiserpientes.lleno = false
            Pause (2)
            SetFramePicture ("caminohaciapuente.jpg")
            camino norestenoreste.pasolibre = true
          }
          else {
            msg ("Hmmmm... parece que tu espray antiserpientes está vacío.")
          }
        }
        else if ((object)=casco) {
          msg ("Le das una manita.. y queda limpio como el jaspe")
        }
        else if ((object)=espada) {
          msg ("Le das un enjuague y queda reluciente.")
        }
        else {
        }
      }
      else {
        msg ("No tienes el poderosísimo rayo-espray mata-serpiente especial  \"Las mata bien gordas\".")
      }
    </script>
  </command>
  <command name="Matar Bicho">
    <pattern type="string"><![CDATA[(^matar|^mata|^asesinar|^asesina|^cargate|^cargarse|^destruir|^destruye|^ejecutar|^ejecuta|^eliminar|^elimina|^exterminar|^extermina|^cortar|^corta|^partir|^parte|^herir|^hiere|^golpear|^golpea) serpiente con (?<object>.*)]]></pattern>
    <unresolved>No veo eso.</unresolved>
    <script>
      if ((object)=espada) {
        msg ("Tu espada es demasiado corta como para acercarte a la serpiente. Antes de dar el mandoble, te engulliría como si fueses un conejo.")
      }
      else if ((object)=casco) {
        msg ("¿Matar a una serpiente de ese tamaño con el casco? Venga... dime la verdad. ¿Qué te has fumado?")
      }
      else if ((object)=antiserpientes) {
        msg ("Hmmmm.. no vas mal encaminado, pero seguro que se te ocurre otra acción que hacer con el antiserpientes...")
      }
      else {
        msg ("\"No puedes matar a la serpiente con eso\".")
      }
    </script>
  </command>
  <command name="MATAR VIEJO">
    <pattern>mata viejo con espada; matar viejo con espada;matar al viejo con la espada; mata al viejo con la espada; matar con la espada al viejo;  mata con la espada al viejo; mata con espada a viejo; matar con espada a viejo; matar al viejo con espada; mata al viejo con espada;matar viejo;mata viejo</pattern>
    <script>
      if (player.parent = CasaViejo) {
        msg ("Sé que se lo merece, pero todavía es muy joven para morir.")
      }
      else {
        msg ("No ves al viejo por ningún sitio.")
      }
    </script>
  </command>
  <verb name="Quemar">
    <property>quemar</property>
    <pattern>quemar; quema;incendiar;incendia;abrasar;abrasa;chamuscar;chamusca</pattern>
    <defaultexpression>"No puedes quemar eso"</defaultexpression>
  </verb>
  <verb name="Quitar">
    <property>quitar</property>
    <pattern>quitar;quita</pattern>
    <defaultexpression>"No puedes quitar eso"</defaultexpression>
  </verb>
  <command name="ABRIR LOSA ESPADA">
    <pattern>abrir losa con espada; abre losa con espada; abrir la losa con espada;abre la losa con espada; abrir la losa con la espada;abre la losa con la espada;abrir losa con la espada;abre losa con la espada.</pattern>
    <script>
      msg ("Prefieres no intentarlo. La losa es demasiado pesada y podrías partir en dos tu preciosa espada.")
    </script>
  </command>
  <command name="ABRIR LOSA CASCO">
    <pattern>abrir losa con casco; abre losa con casco; abrir la losa con casco;abre la losa con casco; abrir la losa con la casco;abre la losa con la casco;abrir losa con la casco;abre losa con la casco.</pattern>
    <script>
      msg ("¿Tu estás tonto, o qué? ¿Cómo vas a abrir una losa que pesa un quintal con un casco....?")
    </script>
  </command>
  <verb name="Subir">
    <property>subir</property>
    <pattern>subir;subirse;subete;súbete;sube</pattern>
    <defaultexpression>"No puedes subirte a eso."</defaultexpression>
  </verb>
  <command name="PEGAR PATADA A LOSA">
    <pattern>pegar patada losa;pega patada losa;pegar patada a losa;pega patada a losa;pegar patada a la losa;pega patada a la losa.</pattern>
    <unresolved>No puedes pegarle una patada a eso.</unresolved>
    <script>
      msg ("Le das una soberana patada a la losa y... consigues hacerte un daño de cojones en el dedo gordo del pie derecho.")
    </script>
  </command>
  <verb name="Matar">
    <property>matar</property>
    <pattern>matar;mata;asesinar;asesina;chafar;chafa;decapitar;decapita;degollar;degolla;axfisiar;axfisia;envenenar;envenena</pattern>
    <defaultexpression>"No puedes matar eso"</defaultexpression>
  </verb>
  <verb name="Pisar">
    <property>pisar</property>
    <pattern>pisar;pisa</pattern>
    <defaultexpression>"No puedes pisar eso"</defaultexpression>
  </verb>
  <verb name="Golpear">
    <property>golpear</property>
    <pattern>golpear;golpea</pattern>
    <defaultexpression>"No puedes golpear eso"</defaultexpression>
  </verb>
  <verb name="Rodear">
    <property>rodear</property>
    <pattern>rodear;rodea</pattern>
    <defaultexpression>"No puedes rodear eso"</defaultexpression>
  </verb>
  <verb name="Saltar">
    <property>saltar</property>
    <pattern>saltar;salta</pattern>
    <defaultexpression>"No puedes saltar eso"</defaultexpression>
  </verb>
  <verb name="Hipnotizar">
    <property>hipnotizar</property>
    <pattern>hipnotizar;hipnotiza</pattern>
    <defaultexpression>"No puedes hipnotizar eso."</defaultexpression>
  </verb>
  <verb name="Acariciar">
    <property>acariciar</property>
    <pattern>acariciar;acaricia</pattern>
    <defaultexpression>"No puedes acariciar eso."</defaultexpression>
  </verb>
  <verb name="Mirar">
    <property>mirar</property>
    <pattern>mirar;mira</pattern>
    <defaultexpression>"Será mejor que lo examines."</defaultexpression>
  </verb>
  <verb name="Escuchar">
    <property>listento</property>
    <pattern>listen to; listen to;escuchar;escucha</pattern>
    <defaultexpression>"Escuchas, pero no oyes nada que te llame la atención."</defaultexpression>
  </verb>
  <verb name="Morder">
    <property>moder</property>
    <pattern>moder;muerde</pattern>
    <defaultexpression>"No puedes morder eso."</defaultexpression>
  </verb>
  <verb name="Examen Invidentes">
    <property>XI</property>
    <pattern>XI;X INVIDENTE;EXAMINA INVIDENTE;EX INVIDENTE</pattern>
    <defaultexpression>"No hay descripción para invidentes de ese objeto"</defaultexpression>
  </verb>
  <command name="LANZAR PERGAMINO">
    <pattern>(lanzar|lanza|tirar|tira|arrojar|arroja|quemar|quema|poner|pon) pergamino a la hoguera</pattern>
    <unresolved>"Lanzando eso ahí, no conseguirías nada."</unresolved>
    <script>
      if (Got(numero)) {
        if (player.parent = CasaViejo) {
          msg ("Acercas el pergamino a la hoguera y ves con satisfacción como en el hueco del número que falta van apareciendo unos caracteres. El pergamino te lo han enviado los dioses y es incombustible pero crees distinguir unas palabras que han aparecido con el calor. Con cuidado y sin quemarte, recuperas el pergamino y en el hueco del número que falta lees: “Jhames es un borde”.")
        }
        else {
          msg ("Lanzando eso ahí, no conseguirías nada.")
        }
      }
      else {
        msg ("Lanzando eso ahí, no conseguirías nada.")
      }
    </script>
  </command>
  <object name="ciclope">
    <alias>cíclope</alias>
    <usedefaultprefix type="boolean">false</usedefaultprefix>
    <prefix>un</prefix>
    <alt>cíclope; ciclope</alt>
    <presente type="boolean">false</presente>
  </object>
  <command name="Pista">
    <pattern>pistas;pista</pattern>
    <unresolved>"En esta parte del juego todavía no hay pistas."</unresolved>
    <script>
      if (player.parent = camino norestenoreste) {
        msg ("Nearco, atiéndeme bien:")
        SetForegroundColour ("Blue")
        msg ("\"Me parece que en este momento -solamente los dioses- pueden ayudarte. Quizás debas buscarlos...\"")
        SetForegroundColour ("Black")
      }
      else if (player.parent = CasaViejo) {
        msg ("Como puedes apreciar, por lo que está dibujando en la arena, el viejo es un matemático. Necesita que le digas un número que está buscando desde hace mucho tiempo...")
      }
      else if (player.parent = sitiodelaninfa) {
        if (ListContains(ScopeVisible(), ninfa)) {
          msg ("Lo único que necesita la ninfa en este momento es que le respondas a la pregunta que te ha hecho.")
        }
        else {
          msg ("Si es la primera vez que entras aquí. y aún no has visto a nadie, quizás deberías volver... nunca se sabe.")
        }
      }
      else if (player.parent = cementerio1) {
        if (ListContains(ScopeVisible(), craneo)) {
          msg ("Si quieres descifrar las inscripciones del cráneo, búscate un buen mapa de anatomía...")
        }
        else {
          msg ("La losa es demasiado pesada. Quizás deberías buscar algún sistema para romperla. Pero ténlo claro, en esta localidad no vas a encontrar el modo de hacerlo ...")
        }
      }
      else if (player.parent = Cancer) {
        msg ("Si quieres responder el acertijo de Nerea, simplemente di la solución al acertijo que ella te propuso... ")
        msg ("Si quieres hablar con los dioses, teclea: decir nombre_del_dios  problema_que_tienes...")
      }
      else if (player.parent = salida de la cueva) {
        msg ("¡¡¡ Estás en la localidad inicial del juego !!! ¿Y ya quieres pistas?")
      }
      else {
        msg ("En esta parte del juego todavía no hay pistas.")
      }
    </script>
  </command>
  <verb>
    <property>escribir</property>
    <pattern>escribir;escribe</pattern>
    <defaultexpression>"No puedes escribir en eso"</defaultexpression>
  </verb>
  <object name="cementerio">
    <primeravezquesepasa type="boolean">false</primeravezquesepasa>
    <prefix>un</prefix>
    <alias>camino</alias>
    <usedefaultprefix type="boolean">false</usedefaultprefix>
    <picture>lunasinlobo.jpg</picture>
    <description type="string"></description>
    <enter type="script">
      if (cementerio.primeravezquesepasa = false) {
        MoveObject (ciclope, Camino Noroeste)
        cementerio.primeravezquesepasa = true
      }
      else {
        MoveObject (lobo, LIMBO)
        MoveObject (lobo1, cementerio)
      }
    </enter>
    <firstenter type="script">
      play sound ("aullido lobo.mp3", false, false)
      msg ("Estás en la entrada del cementerio. Ves un lobo aullar a la luna desde lo alto de una roca. Un escalofrío recorre tu espina dorsal.")
      SetFramePicture ("lobo.gif")
    </firstenter>
    <exit alias="sureste" to="CaminoCementerio">
      <inherit name="compassdirection" />
      <inherit name="southeastdirection" />
    </exit>
    <exit alias="norte" to="cementerio1">
      <inherit name="compassdirection" />
      <inherit name="northdirection" />
    </exit>
    <object name="lobo">
      <look>El lobo recortando la silueta de la Luna, aúlla, provocando descargas en tu sistema nervioso que te ponen en alerta.</look>
      <scenery />
      <alias>lobo</alias>
    </object>
    <object name="rocadellobo">
      <article>la</article>
      <gender>la</gender>
      <look>Es un peñasco en cuya parte superior se sitúa el lobo para tener una buena visión de sus posibles presas.</look>
      <scenery />
      <alias>roca</alias>
    </object>
    <object name="luna">
      <article>la</article>
      <gender>la</gender>
      <look>Es luna llena. Está preciosa. Su reflejo hace que se iluminen las zonas colindantes, logrando que la visión de los depredadores sea mucho mayor.</look>
      <scenery />
      <alias>luna</alias>
    </object>
    <object name="camino9">
      <alt>cementerio</alt>
      <look>Está tan oscuro que apenas si distingues nada.</look>
      <scenery />
      <alias>camino</alias>
    </object>
  </object>
  <command>
    <pattern>(clavar|clava|hundir|hunde) espada (en|dentro) serpiente</pattern>
    <unresolved>"Haciendo eso, no conseguirías nada."</unresolved>
    <script>
      if (ListContains(ScopeVisible(), serpiente)) {
        msg ("Nop. La serpiente te engulliría de un solo bocado cuando intentases ponerte cerca de ella.")
      }
      else {
        msg ("Haciendo eso, no conseguirías nada.")
      }
    </script>
  </command>
  <verb name="Cortar">
    <property>cortar</property>
    <pattern>cortar;corta</pattern>
    <defaultexpression>"No vas a necesitar cortar eso"</defaultexpression>
  </verb>
  <type name="defaultverb">
    <script type="script">
      switch (TypeOf(object, this.property)) {
        case ("script") {
          do (object, this.property)
        }
        case ("string") {
          msg (GetString(object, this.property))
        }
        case ("null") {
          if (not this.defaulttext = null) {
            msg (this.defaulttext)
          }
          else if (not this.defaulttemplate = null) {
            msg (DynamicTemplate(this.defaulttemplate, object))
          }
          else if (not this.defaultexpression = null) {
            params = NewDictionary()
            dictionary add (params, "object", object)
            msg (Eval(this.defaultexpression, params))
          }
          else {
            error ("No verb response defined")
          }
        }
        default {
          error ("No verb response defined")
        }
      }
    </script>
  </type>
  <type name="defaultgame">
    <enablehyperlinks />
    <showdescriptiononenter />
    <autodescription />
    <defaultfont>Arial</defaultfont>
    <defaultfontsize type="int">9</defaultfontsize>
    <defaultbackground>White</defaultbackground>
    <defaultforeground>Black</defaultforeground>
    <defaultlinkforeground>Blue</defaultlinkforeground>
    <compassdirections type="list">noroeste; norte; noreste; oeste; este; suroeste; sur; sureste; arriba; abajo; in; fuera</compassdirections>
    <useframe type="boolean">false</useframe>
    <clearframe type="boolean">false</clearframe>
    <timeelapsed type="int">0</timeelapsed>
    <appendobjectdescription type="boolean">false</appendobjectdescription>
    <allobjects type="list">todo; todos</allobjects>
    <parserignoreprefixes type="list">el; la; un; una; unos; al; a la</parserignoreprefixes>
    <displayroomdescriptiononstart />
    <showpanes />
  </type>
  <type name="defaultobject">
    <displayverbs type="list">Examinar; Coger</displayverbs>
    <inventoryverbs type="list">Examinar; Usar; Dejar</inventoryverbs>
    <take type="boolean">false</take>
    <drop />
    <gender>lo</gender>
    <article>el</article>
    <isopen type="boolean">false</isopen>
    <open type="boolean">false</open>
    <close type="boolean">false</close>
    <container type="boolean">false</container>
    <descprefix>Estás en</descprefix>
    <objectslistprefix>Puedes ver</objectslistprefix>
    <exitslistprefix>Puedes ir</exitslistprefix>
    <contentsprefix>conteniendo</contentsprefix>
    <description type="string"></description>
    <scenery type="boolean">false</scenery>
    <hidechildren type="boolean">false</hidechildren>
    <listchildren type="boolean">false</listchildren>
    <usedefaultprefix />
    <changedisopen type="script">
      if (this.isopen and HasScript(this, "onopen")) {
        do (this, "onopen")
      }
      if (not this.isopen and HasScript(this, "onclose")) {
        do (this, "onclose")
      }
    </changedisopen>
    <changedlocked type="script">
      if (this.locked and HasScript(this, "onlock")) {
        do (this, "onlock")
      }
      if (not this.locked and HasScript(this, "onunlock")) {
        do (this, "onunlock")
      }
    </changedlocked>
    <changedswitchedon type="script">
      if (this.switchedon and HasScript(this, "onswitchon")) {
        do (this, "onswitchon")
      }
      if (not this.switchedon and HasScript(this, "onswitchoff")) {
        do (this, "onswitchoff")
      }
    </changedswitchedon>
  </type>
  <type name="defaultexit">
    <displayverbs type="list">Ir a</displayverbs>
    <locked type="boolean">false</locked>
    <lockmessage>Esa dirección está bloqueada.</lockmessage>
    <lookonly type="boolean">false</lookonly>
  </type>
  <type name="direction">
    <displayverbs type="list">Ir</displayverbs>
  </type>
  <type name="compassdirection">
    <inherit name="direction" />
    <prefix>al</prefix>
  </type>
  <type name="updowndirection">
    <inherit name="direction" />
    <prefix type="string"></prefix>
  </type>
  <type name="inoutdirection">
    <inherit name="direction" />
    <prefix type="string"></prefix>
  </type>
  <type name="northwestdirection">
    <inherit name="compassdirection" />
    <alias>noroeste</alias>
    <alt type="list">no</alt>
  </type>
  <type name="northdirection">
    <inherit name="compassdirection" />
    <alias>norte</alias>
    <alt type="list">n</alt>
  </type>
  <type name="northeastdirection">
    <inherit name="compassdirection" />
    <alias>noreste</alias>
    <alt type="list">ne</alt>
  </type>
  <type name="westdirection">
    <inherit name="compassdirection" />
    <alias>oeste</alias>
    <alt type="list">o</alt>
  </type>
  <type name="eastdirection">
    <inherit name="compassdirection" />
    <alias>este</alias>
    <alt type="list">e</alt>
  </type>
  <type name="southwestdirection">
    <inherit name="compassdirection" />
    <alias>suroeste</alias>
    <alt type="list">so</alt>
  </type>
  <type name="southdirection">
    <inherit name="compassdirection" />
    <alias>sur</alias>
    <alt type="list">s</alt>
  </type>
  <type name="southeastdirection">
    <inherit name="compassdirection" />
    <alias>sureste</alias>
    <alt type="list">se</alt>
  </type>
  <type name="updirection">
    <inherit name="updowndirection" />
    <alias>arriba</alias>
    <alt type="list">up</alt>
  </type>
  <type name="downdirection">
    <inherit name="updowndirection" />
    <alias>abajo</alias>
    <alt type="list">down</alt>
  </type>
  <type name="indirection">
    <inherit name="inoutdirection" />
    <alias>in</alias>
    <alt type="list">in</alt>
  </type>
  <type name="outdirection">
    <inherit name="inoutdirection" />
    <alias>fuera</alias>
    <alt type="list">out</alt>
  </type>
  <type name="defaultcommand">
    <pattern type="simplepattern"></pattern>
  </type>
  <type name="male">
    <displayverbs type="list">Examinar; Decir a</displayverbs>
    <gender>lo</gender>
    <article>el</article>
  </type>
  <type name="female">
    <displayverbs type="list">Examinar; Decir a</displayverbs>
    <gender>la</gender>
    <article>la</article>
  </type>
  <type name="plural">
    <gender>they</gender>
    <article>them</article>
  </type>
  <type name="maleplural">
    <displayverbs type="list">Examinar; Decir a</displayverbs>
    <gender>they</gender>
    <article>them</article>
  </type>
  <type name="femaleplural">
    <displayverbs type="list">Examinar; Decir a</displayverbs>
    <gender>they</gender>
    <article>them</article>
  </type>
  <type name="openable">
    <open />
    <close />
  </type>
  <type name="container_base">
    <container />
  </type>
  <type name="container_closed">
    <inherit name="container_base" />
    <open />
    <close />
  </type>
  <type name="container_open">
    <inherit name="container_base" />
    <isopen />
    <open />
    <close />
  </type>
  <type name="surface">
    <inherit name="container_base" />
    <isopen />
    <transparent />
    <contentsprefix>y dentro hay</contentsprefix>
  </type>
  <type name="container">
    <inherit name="container_open" />
  </type>
  <type name="container_limited">
    <inherit name="container" />
    <maxobjects type="int">1</maxobjects>
    <addscript type="AddScript"><![CDATA[
      children = GetDirectChildren(this)
      if (listcount(children) >= this.maxobjects) {
        if (HasString(this, "containerfullmessage")) {
          msg (this.containerfullmessage)
        }
        else {
          msg (DynamicTemplate("ContainerFull", this))
        }
      }
      else {
        object.parent = this
        msg (Template("Done"))
      }
    ]]></addscript>
  </type>
  <type name="container_lockable">
    <locked />
    <nokeymessage>You do not have the key.</nokeymessage>
    <unlockmessage>Unlocked.</unlockmessage>
    <lockmessage>Locked.</lockmessage>
    <canlockopen type="boolean">false</canlockopen>
    <autoopen />
    <autounlock />
    <openscript type="script">
      if (this.locked) {
        if (this.autounlock and ListContains(ScopeInventory(), this.key)) {
          do (this, "unlock")
          if (not this.isopen) {
            OpenObject (this)
          }
        }
        else {
          msg (DynamicTemplate("LockedObject", this))
        }
      }
      else {
        OpenObject (this)
      }
    </openscript>
    <closescript type="script">
      if (this.locked) {
        msg (DynamicTemplate("LockedObject", this))
      }
      else {
        CloseObject (this)
      }
    </closescript>
    <lock type="script">
      if (this.locked) {
        msg (DynamicTemplate("AlreadyLocked", this))
      }
      else if (this.isopen and not this.canlockopen) {
        msg (DynamicTemplate("CannotLockOpen", this))
      }
      else {
        if (ListContains(ScopeInventory(), this.key)) {
          msg (this.lockmessage)
          this.locked = true
        }
        else {
          msg (this.nokeymessage)
        }
      }
    </lock>
    <unlock type="script">
      if (not this.locked) {
        msg (DynamicTemplate("AlreadyUnlocked", this))
      }
      else {
        if (ListContains(ScopeInventory(), this.key)) {
          msg (this.unlockmessage)
          this.locked = false
          if (this.autoopen and not this.isopen) {
            TryOpenClose (true, this)
          }
        }
        else {
          msg (this.nokeymessage)
        }
      }
    </unlock>
  </type>
  <type name="defaultplayer">
    <alias>me</alias>
    <alt type="list">myself; self</alt>
    <scenery />
    <look>Parece bueno.</look>
    <gender>tu</gender>
    <article>tu mismo</article>
    <changedparent type="script">
      OnEnterRoom
    </changedparent>
  </type>
  <type name="switchable">
    <switchedon type="boolean">false</switchedon>
    <turnon type="script">
      if (this.switchedon) {
        msg (DynamicTemplate("AlreadySwitchedOn", this))
      }
      else {
        if (HasString(this, "switchonmsg")) {
          msg (this.switchonmsg)
        }
        else {
          msg (DynamicTemplate("SwitchedOn", this))
        }
        this.switchedon = true
      }
    </turnon>
    <turnoff type="script">
      if (not this.switchedon) {
        msg (DynamicTemplate("AlreadySwitchedOff", this))
      }
      else {
        if (HasString(this, "switchoffmsg")) {
          msg (this.switchoffmsg)
        }
        else {
          msg (DynamicTemplate("SwitchedOff", this))
        }
        this.switchedon = false
      }
    </turnoff>
  </type>
  <function name="GetDefaultPrefix" parameters="obj" type="string"><![CDATA[
    if (Instr("aeiou", Left(GetDisplayAlias(obj), 1)) > 0) {
      return ("un")
    }
    else {
      return ("")
    }
  ]]></function>
  <function name="WriteVerb" parameters="obj, verb" type="string">
    return (CapFirst(obj.gender) + " " + Conjugate(obj, verb))
  </function>
  <function name="Conjugate" parameters="obj, verb" type="string">
    gender = obj.gender
    if (gender = "he" or gender = "she") {
      gender = "it"
    }
    switch (verb) {
      case ("be") {
        switch (gender) {
          case ("i") {
            return ("am")
          }
          case ("you") {
            return ("are")
          }
          case ("it") {
            return ("is")
          }
          case ("we") {
            return ("are")
          }
          case ("they") {
            return ("are")
          }
          default {
            return ("is")
          }
        }
      }
      case ("do") {
        switch (gender) {
          case ("i") {
            return ("do")
          }
          case ("you") {
            return ("do")
          }
          case ("it") {
            return ("does")
          }
          case ("we") {
            return ("do")
          }
          case ("they") {
            return ("do")
          }
          default {
            return ("do")
          }
        }
      }
      default {
        if (gender = "it") {
          return (verb + "s")
        }
        else {
          return (verb)
        }
      }
    }
  </function>
  <function name="ListObjectContents" parameters="object"><![CDATA[
    if (GetBoolean(object, "isopen") and GetBoolean(object, "listchildren")) {
      if (GetBoolean(object, "hidechildren")) {
        object.hidechildren = false
      }
      if (HasString(object, "listchildrenprefix")) {
        listprefix = object.listchildrenprefix
      }
      else {
        listprefix = DynamicTemplate("ObjectContains", object)
      }
      list = FormatObjectList(listprefix, object, Template("And"), ".", false)
      if (list <> "") {
        msg (list)
      }
    }
  ]]></function>
  <function name="DoTake" parameters="object, ismultiple"><![CDATA[
    prefix = ""
    if (ismultiple) {
      prefix = GetDisplayAlias(object) + ": "
    }
    if (object.parent = player) {
      msg (prefix + DynamicTemplate("AlreadyTaken", object))
    }
    else if (not ListContains(ScopeReachable(), object)) {
      msg (prefix + DynamicTemplate("ObjectNotOpen", GetBlockingObject(object)))
    }
    else {
      found = true
      takemsg = object.takemsg
      switch (TypeOf(object, "take")) {
        case ("script") {
          if (ismultiple) {
            msg (prefix)
          }
          do (object, "take")
          takemsg = ""
        }
        case ("boolean") {
          if (object.take = true) {
            object.parent = player
            if (takemsg = null) {
              takemsg = DynamicTemplate("TakeSuccessful", object)
            }
          }
          else {
            found = false
          }
        }
        case ("string") {
          object.parent = player
          takemsg = object.take
        }
        default {
          found = false
        }
      }
      if (not found and takemsg = null) {
        takemsg = DynamicTemplate("TakeUnsuccessful", object)
      }
      if (LengthOf(takemsg) > 0) {
        msg (prefix + takemsg)
      }
      if (HasScript(object, "ontake")) {
        do (object, "ontake")
      }
    }
  ]]></function>
  <function name="DoDrop" parameters="object, ismultiple"><![CDATA[
    prefix = ""
    if (ismultiple) {
      prefix = GetDisplayAlias(object) + ": "
    }
    if (not ListContains(ScopeInventory(), object)) {
      msg (prefix + DynamicTemplate("NotCarrying", object))
    }
    else if (not ListContains(ScopeReachable(), object)) {
      msg (prefix + DynamicTemplate("ObjectNotOpen", GetBlockingObject(object)))
    }
    else {
      found = true
      dropmsg = object.dropmsg
      switch (TypeOf(object, "drop")) {
        case ("script") {
          if (ismultiple) {
            msg (prefix)
          }
          do (object, "drop")
          dropmsg = ""
        }
        case ("boolean") {
          if (object.drop = true) {
            object.parent = player.parent
            if (dropmsg = null) {
              dropmsg = DynamicTemplate("DropSuccessful", object)
            }
          }
          else {
            found = false
          }
        }
        case ("string") {
          object.parent = player.parent
          dropmsg = object.drop
        }
        default {
          found = false
        }
      }
      if (not found and dropmsg = null) {
        dropmsg = DynamicTemplate("DropUnsuccessful", object)
      }
      if (LengthOf(dropmsg) > 0) {
        msg (prefix + dropmsg)
      }
      if (HasScript(object, "ondrop")) {
        do (object, "ondrop")
      }
    }
  ]]></function>
  <function name="TryOpenClose" parameters="open, object">
    if (open) {
      action = "open"
      scriptaction = "openscript"
    }
    else {
      action = "close"
      scriptaction = "closescript"
    }
    if (not ListContains(ScopeReachable(), object)) {
      msg (DynamicTemplate("ObjectNotOpen", GetBlockingObject(object)))
    }
    else {
      found = false
      if (GetBoolean(object, action)) {
        if (open) {
          if (object.isopen) {
            msg (DynamicTemplate("AlreadyOpen", object))
          }
          else {
            if (HasScript(object, scriptaction)) {
              do (object, scriptaction)
            }
            else {
              OpenObject (object)
            }
          }
        }
        else {
          if (not object.isopen) {
            msg (DynamicTemplate("AlreadyClosed", object))
          }
          else {
            if (HasScript(object, scriptaction)) {
              do (object, scriptaction)
            }
            else {
              CloseObject (object)
            }
          }
        }
      }
      else {
        if (open) {
          msg (DynamicTemplate("CantOpen", object))
        }
        else {
          msg (DynamicTemplate("CantClose", object))
        }
      }
    }
  </function>
  <function name="OpenObject" parameters="object">
    msg (DynamicTemplate("OpenSuccessful", object))
    object.isopen = true
    ListObjectContents (object)
  </function>
  <function name="CloseObject" parameters="object">
    msg (DynamicTemplate("CloseSuccessful", object))
    object.isopen = false
  </function>
  <function name="DoAskTell" parameters="object, text, property, defaultscript, defaulttemplate"><![CDATA[
    handled = false
    maxstrength = 0
    match = null
    text = LCase(text)
    if (typeof(object, property) = "scriptdictionary") {
      dictionary = GetAttribute(object, property)
      foreach (keywords, dictionary) {
        if (GetKeywordsMatchStrength(LCase(keywords), text) > maxstrength) {
          match = ScriptDictionaryItem(dictionary, keywords)
        }
      }
      if (match <> null) {
        invoke (match)
        handled = true
      }
    }
    if (not handled) {
      if (HasScript(object, defaultscript)) {
        do (object, defaultscript)
      }
      else {
        msg (DynamicTemplate(defaulttemplate, object))
      }
    }
  ]]></function>
  <function name="GetKeywordsMatchStrength" parameters="keywords, input" type="int">
    keywordlist = Split(keywords, " ")
    inputlist = Split(input, " ")
    strength = 0
    foreach (word, inputlist) {
      foreach (keyword, keywordlist) {
        if (StartsWith(word, keyword)) {
          strength = strength + LengthOf(keyword)
        }
      }
    }
    return (strength)
  </function>
  <function name="CompareNames" parameters="name, value, obj, fullmatches, partialmatches"><![CDATA[
    if (name = value) {
      if (not ListContains(fullmatches, obj)) {
        list add (fullmatches, obj)
      }
    }
    else {
      if (StartsWith(name, value)) {
        if (not ListContains(partialmatches, obj)) {
          list add (partialmatches, obj)
        }
      }
      else {
        if (Instr(name, " " + value) > 0) {
          if (not ListContains(partialmatches, obj)) {
            list add (partialmatches, obj)
          }
        }
      }
    }
  ]]></function>
  <function name="GenerateMenuChoices" parameters="dictionary, objects">
    foreach (obj, objects) {
      dictionary add (dictionary, obj.name, GetDisplayAlias(obj))
    }
  </function>
  <function name="ResolveName" parameters="value, objtype" type="object">
    result = ResolveNameInternal(value, objtype)
    if (not result = null) {
      return (result)
    }
    else {
      foreach (prefix, game.parserignoreprefixes) {
        if (StartsWith(value, prefix + " ")) {
          result = ResolveNameInternal(Mid(value, LengthOf(prefix) + 1), objtype)
        }
      }
      return (result)
    }
  </function>
  <function name="ResolveNameInternal" parameters="value, objtype" type="object">
    fullmatches = NewObjectList()
    partialmatches = NewObjectList()
    if (objtype = "object") {
      scope = ScopeVisible()
    }
    else if (objtype = "exit") {
      scope = ScopeExitsAll()
    }
    value = Trim(value)
    foreach (obj, scope) {
      name = LCase(GetDisplayAlias(obj))
      CompareNames (name, value, obj, fullmatches, partialmatches)
      if (not obj.alt = null) {
        foreach (altname, obj.alt) {
          CompareNames (LCase(altname), value, obj, fullmatches, partialmatches)
        }
      }
    }
    if (not game.lastobjects = null) {
      foreach (obj, game.lastobjects) {
        CompareNames (LCase(obj.article), value, obj, fullmatches, partialmatches)
        CompareNames (LCase(obj.gender), value, obj, fullmatches, partialmatches)
      }
    }
    if (ListCount(fullmatches) = 1) {
      return (ListItem(fullmatches, 0))
    }
    else if (ListCount(fullmatches) = 0 and ListCount(partialmatches) = 1) {
      return (ListItem(partialmatches, 0))
    }
    else if (ListCount(fullmatches) + ListCount(partialmatches) = 0) {
      return (null)
    }
    else {
      menu = NewStringDictionary()
      GenerateMenuChoices (menu, fullmatches)
      GenerateMenuChoices (menu, partialmatches)
      result = ShowMenu(DynamicTemplate("DisambiguateMenu", value), menu, true)
      if (result = null) {
        return (null)
      }
      else {
        return (GetObject(result))
      }
    }
  </function>
  <function name="ResolveNameList" parameters="value, scope, objtype, resultdictionary" type="objectlist"><![CDATA[
    result = NewObjectList()
    isfinished = false
    inputlist = Split(value, ",")
    foreach (inputbase, inputlist) {
      inputlist2 = Split(inputbase, Template("And"))
      foreach (input, inputlist2) {
        if (not isfinished) {
          newitem = ResolveNameListItem(Trim(input), scope, objtype, resultdictionary)
          if (newitem = null) {
            isfinished = true
            result = null
          }
          else {
            result = result + newitem
          }
        }
      }
    }
    if (result <> null) {
      if (ListCount(result) > 1) {
        if (not DictionaryContains(resultdictionary, "multiple")) {
          dictionary add (resultdictionary, "multiple", true)
        }
      }
    }
    return (result)
  ]]></function>
  <function name="ResolveNameListItem" parameters="value, scope, objtype, resultdictionary" type="objectlist">
    if (ListContains(game.allobjects, value)) {
      if (not DictionaryContains(resultdictionary, "multiple")) {
        dictionary add (resultdictionary, "multiple", true)
      }
      return (scope)
    }
    else {
      object = ResolveName(value, objtype)
      if (object = null) {
        return (null)
      }
      else {
        result = NewObjectList()
        list add (result, object)
        return (result)
      }
    }
  </function>
  <function name="HandleCommand" parameters="command"><![CDATA[
    commands = Split(command, ".")
    foreach (command, commands) {
      command = Trim(command)
      if (LengthOf(command) > 0) {
        HandleSingleCommand (command)
      }
    }
  ]]></function>
  <function name="HandleSingleCommand" parameters="command"><![CDATA[
    candidates = NewObjectList()
    foreach (cmd, ScopeCommands()) {
      if (IsRegexMatch(cmd.pattern, command)) {
        list add (candidates, cmd)
      }
    }
    maxstrength = -1
    thiscommand = null
    foreach (candidate, candidates) {
      strength = GetMatchStrength(candidate.pattern, command)
      if (strength >= maxstrength) {
        thiscommand = candidate
        maxstrength = strength
      }
    }
    if (thiscommand = null) {
      msg (Template("UnrecognisedCommand"))
    }
    else {
      varlist = Populate(thiscommand.pattern, command)
      HandleSingleCommandPattern (command, thiscommand, varlist)
    }
    RunTurnScripts
    UpdateStatusAttributes
  ]]></function>
  <function name="HandleSingleCommandPattern" parameters="command, thiscommand, varlist"><![CDATA[
    resolved = true
    resolvedelements = NewDictionary()
    resolvedobjects = NewObjectList()
    unresolvedobject = null
    foreach (var, varlist) {
      if (resolved) {
        value = LCase(StringDictionaryItem(varlist, var))
        result = null
        if (StartsWith(var, "object")) {
          if (HasDelegateImplementation(thiscommand, "multiple")) {
            result = ResolveNameList(value, RunDelegateFunction(thiscommand, "multiple"), "object", resolvedelements)
            if (not result = null) {
              foreach (obj, result) {
                list add (resolvedobjects, obj)
              }
            }
          }
          else {
            result = ResolveName(value, "object")
            if (not result = null) {
              list add (resolvedobjects, result)
            }
          }
        }
        else if (StartsWith(var, "exit")) {
          result = ResolveName(value, "exit")
        }
        else if (StartsWith(var, "text")) {
          result = StringDictionaryItem(varlist, var)
        }
        else {
          error ("Unhandled command variable '" + var + "'")
        }
        if (result = null) {
          resolved = false
          unresolvedobject = value
          unresolvedkey = var
        }
        else {
          dictionary add (resolvedelements, var, result)
        }
      }
    }
    game.lastobjects = resolvedobjects
    if (not DictionaryContains(resolvedelements, "multiple")) {
      dictionary add (resolvedelements, "multiple", false)
    }
    if (resolved) {
      if (not GetBoolean(thiscommand, "isundo")) {
        if (LengthOf(command) > 0) {
          start transaction (command)
        }
      }
      if (not GetBoolean(thiscommand, "isoops")) {
        game.unresolvedcommand = null
        game.unresolvedcommandvarlist = null
        game.unresolvedcommandkey = null
      }
      do (thiscommand, "script", resolvedelements)
    }
    else {
      if (HasString(thiscommand, "unresolved")) {
        if (ListCount(varlist) > 1) {
          msg (thiscommand.unresolved + " (" + unresolvedobject + ")")
        }
        else {
          msg (thiscommand.unresolved)
        }
      }
      else {
        if (ListCount(varlist) > 1) {
          msg (Template("UnresolvedObject") + " (" + unresolvedobject + ")")
        }
        else {
          msg (Template("UnresolvedObject"))
        }
      }
      game.unresolvedcommand = thiscommand
      game.unresolvedcommandvarlist = varlist
      game.unresolvedcommandkey = unresolvedkey
    }
  ]]></function>
  <function name="GetPlacesObjectsList" type="objectlist">
    return (ScopeVisibleNotHeldNotScenery() - player)
  </function>
  <function name="ScopeInventory" type="objectlist">
    result = NewObjectList()
    foreach (obj, AllObjects()) {
      if (ContainsVisible(player, obj)) {
        list add (result, obj)
      }
    }
    return (result)
  </function>
  <function name="ScopeReachableInventory" type="objectlist">
    result = NewObjectList()
    foreach (obj, AllObjects()) {
      if (ContainsReachable(player, obj)) {
        list add (result, obj)
      }
    }
    return (result)
  </function>
  <function name="ScopeVisibleNotHeld" type="objectlist">
    return (ScopeVisibleNotHeldForRoom(player.parent))
  </function>
  <function name="ScopeVisibleNotHeldForRoom" parameters="room" type="objectlist">
    if (room = player.parent) {
      return (ScopeReachableNotHeldForRoom(room) + ScopeVisibleNotReachableForRoom(room) + player)
    }
    else {
      return (ScopeReachableNotHeldForRoom(room) + ScopeVisibleNotReachableForRoom(room))
    }
  </function>
  <function name="ScopeVisibleNotHeldNotScenery" type="objectlist">
    return (ScopeVisibleNotHeldNotSceneryForRoom(player.parent))
  </function>
  <function name="ScopeVisibleNotHeldNotSceneryForRoom" parameters="room" type="objectlist">
    return (RemoveSceneryObjects(ScopeVisibleNotHeldForRoom(room)))
  </function>
  <function name="ScopeReachable" type="objectlist">
    return (ScopeReachableForRoom(player.parent))
  </function>
  <function name="ScopeReachableForRoom" parameters="room" type="objectlist">
    if (room = player.parent) {
      result = ScopeReachableNotHeldForRoom(room) + ScopeReachableInventory()
      list add (result, player)
    }
    else {
      result = ScopeReachableNotHeldForRoom(room)
    }
    return (result)
  </function>
  <function name="ScopeVisibleNotReachable" type="objectlist">
    return (ScopeVisibleNotReachableForRoom(player.parent))
  </function>
  <function name="ScopeVisibleNotReachableForRoom" parameters="room" type="objectlist">
    result = NewObjectList()
    exclude = ScopeReachableForRoom(room)
    list add (exclude, player)
    newParent = GetNonTransparentParent(room)
    foreach (obj, AllObjects()) {
      if (ContainsVisible(newParent, obj) and not ListContains(exclude, obj)) {
        list add (result, obj)
      }
    }
    return (result)
  </function>
  <function name="GetNonTransparentParent" parameters="room" type="object">
    if (GetBoolean(room, "transparent")) {
      if (room.parent = null) {
        return (room)
      }
      else {
        return (GetNonTransparentParent(room.parent))
      }
    }
    else {
      return (room)
    }
  </function>
  <function name="ScopeReachableNotHeld" type="objectlist">
    return (ScopeReachableNotHeldForRoom(player.parent))
  </function>
  <function name="ScopeReachableNotHeldForRoom" parameters="room" type="objectlist"><![CDATA[
    result = NewObjectList()
    foreach (obj, AllObjects()) {
      if (ContainsReachable(room, obj) and obj <> player and not Contains(player, obj)) {
        list add (result, obj)
      }
    }
    return (result)
  ]]></function>
  <function name="ScopeVisible" type="objectlist">
    return (ScopeVisibleForRoom(player.parent))
  </function>
  <function name="ScopeVisibleForRoom" parameters="room" type="objectlist">
    if (room = player.parent) {
      return (ScopeVisibleNotHeldForRoom(room) + ScopeInventory())
    }
    else {
      return (ScopeVisibleNotHeldForRoom(room))
    }
  </function>
  <function name="ScopeExits" type="objectlist">
    return (ScopeExitsForRoom(player.parent))
  </function>
  <function name="ScopeExitsForRoom" parameters="room" type="objectlist">
    result = NewObjectList()
    foreach (exit, AllExits()) {
      if (exit.parent = room and not GetBoolean(exit, "lookonly")) {
        list add (result, exit)
      }
    }
    return (result)
  </function>
  <function name="ScopeExitsAll" type="objectlist">
    return (ScopeAllExitsForRoom(player.parent))
  </function>
  <function name="ScopeAllExitsForRoom" parameters="room" type="objectlist">
    result = NewObjectList()
    foreach (exit, AllExits()) {
      if (exit.parent = room) {
        list add (result, exit)
      }
    }
    return (result)
  </function>
  <function name="ScopeCommands" type="objectlist">
    result = NewObjectList()
    foreach (command, AllCommands()) {
      if (command.parent = null or command.parent = player.parent) {
        list add (result, command)
      }
    }
    return (result)
  </function>
  <function name="GetBlockingObject" parameters="obj" type="object">
    result = null
    foreach (obj, ListParents(obj)) {
      if (result = null and not CanReachThrough(obj)) {
        result = obj
      }
    }
    return (result)
  </function>
  <function name="ListParents" parameters="obj" type="objectlist"><![CDATA[
    result = NewObjectList()
    if (obj.parent <> null) {
      result = obj.parent + ListParents(obj.parent)
    }
    return (result)
  ]]></function>
  <function name="ContainsVisible" parameters="parentObj, searchObj" type="boolean">
    return (ContainsAccessible(parentObj, searchObj, false))
  </function>
  <function name="ContainsReachable" parameters="parentObj, searchObj" type="boolean">
    return (ContainsAccessible(parentObj, searchObj, true))
  </function>
  <function name="ContainsAccessible" parameters="parentObj, searchObj, onlyReachable" type="boolean">
    if (not HasObject(searchObj, "parent")) {
      return (false)
    }
    else {
      if (searchObj.parent = null) {
        return (false)
      }
      else if (searchObj.parent = parentObj) {
        return (true)
      }
      else {
        if (onlyReachable) {
          canAdd = CanReachThrough(searchObj.parent)
        }
        else {
          canAdd = CanSeeThrough(searchObj.parent)
        }
        if (canAdd) {
          return (ContainsAccessible(parentObj, searchObj.parent, onlyReachable))
        }
        else {
          return (false)
        }
      }
    }
  </function>
  <function name="CanSeeThrough" parameters="obj" type="boolean">
    return (GetBoolean(obj, "transparent") or CanReachThrough(obj))
  </function>
  <function name="CanReachThrough" parameters="obj" type="boolean">
    return (GetBoolean(obj, "isopen") and not GetBoolean(obj, "hidechildren"))
  </function>
  <function name="Got" parameters="obj" type="boolean">
    return (ListContains(ScopeInventory(), obj))
  </function>
  <function name="ShowRoomDescription"><![CDATA[
    if (HasScript(player.parent, "description")) {
      do (player.parent, "description")
    }
    else {
      if (game.autodescription) {
        youarein = player.parent.descprefix
        msg (youarein + " " + GetDisplayName(player.parent) + ".")
        desc = FormatObjectList(player.parent.objectslistprefix, GetNonTransparentParent(player.parent), Template("And"), ".", false)
        exits = FormatExitList(player.parent.exitslistprefix, ScopeExits(), Template("Or"), ".")
        fulldesc = ""
        if (LengthOf(desc) > 0) {
          fulldesc = desc
          if (LengthOf(exits) > 0) {
            fulldesc = fulldesc + "<br />"
          }
        }
        if (LengthOf(exits) > 0) {
          fulldesc = fulldesc + exits
        }
        if (LengthOf(fulldesc) > 0) {
          msg (fulldesc)
        }
      }
      fulldesc = ""
      if (HasString(player.parent, "description")) {
        if (LengthOf(player.parent.description) > 0) {
          fulldesc = player.parent.description
        }
      }
      if (game.appendobjectdescription) {
        foreach (val, ScopeVisibleNotHeld()) {
          if (HasString(val, "description")) {
            if (LengthOf(val.description) > 0 and val <> player) {
              fulldesc = fulldesc + " " + val.description
            }
          }
        }
      }
      if (LengthOf(fulldesc) > 0) {
        msg (fulldesc)
      }
    }
  ]]></function>
  <function name="OnEnterRoom"><![CDATA[
    game.displayroomdescriptiononstart = false
    if ((not GetBoolean(player.parent, "visited")) and HasScript(player.parent, "beforefirstenter")) {
      do (player.parent, "beforefirstenter")
    }
    request (UpdateLocation, CapFirst(GetDisplayName(player.parent)))
    if (game.useframe) {
      roomFrameExists = false
      if (HasString(player.parent, "picture")) {
        if (LengthOf(player.parent.picture) > 0) {
          roomFrameExists = true
          SetFramePicture (player.parent.picture)
        }
      }
      if (game.clearframe and not roomFrameExists) {
        ClearFramePicture
      }
    }
    if (game.showdescriptiononenter) {
      ShowRoomDescription
    }
    if ((not GetBoolean(player.parent, "visited")) and HasScript(player.parent, "firstenter")) {
      do (player.parent, "firstenter")
    }
    set (player.parent, "visited", true)
    if (HasScript(player.parent, "enter")) {
      do (player.parent, "enter")
    }
  ]]></function>
  <function name="FormatObjectList" parameters="preList, parent, preFinal, postList, useinventoryverbs" type="string"><![CDATA[
    result = ""
    count = 0
    list = RemoveSceneryObjects(GetDirectChildren(parent))
    listLength = ListCount(list)
    foreach (item, list) {
      if (LengthOf(result) = 0) {
        result = preList + " "
      }
      if (useinventoryverbs) {
        verbs = item.inventoryverbs
      }
      else {
        verbs = item.displayverbs
      }
      result = result + GetDisplayNameLink(item, "object", verbs)
      if (CanSeeThrough(item)) {
        result = result + FormatObjectList(" (" + item.contentsprefix, item, preFinal, ")", useinventoryverbs)
      }
      count = count + 1
      if (count = listLength - 1) {
        result = result + " " + preFinal + " "
      }
      else if (count < listLength) {
        result = result + ", "
      }
      else {
        result = result + postList
      }
    }
    return (result)
  ]]></function>
  <function name="GetDirectChildren" parameters="parent" type="objectlist"><![CDATA[
    result = NewObjectList()
    foreach (obj, AllObjects()) {
      if (obj.parent = parent and obj <> player) {
        list add (result, obj)
      }
    }
    return (result)
  ]]></function>
  <function name="RemoveSceneryObjects" parameters="list" type="objectlist">
    result = NewObjectList()
    foreach (obj, list) {
      if (not obj.scenery) {
        list add (result, obj)
      }
    }
    return (result)
  </function>
  <function name="FormatExitList" parameters="preList, list, preFinal, postList" type="string"><![CDATA[
    result = ""
    count = 0
    listLength = ListCount(list)
    foreach (item, list) {
      if (LengthOf(result) = 0) {
        result = preList + " "
      }
      result = result + GetDisplayNameLink(item, "exit", item.displayverbs)
      count = count + 1
      if (count = listLength - 1) {
        result = result + " " + preFinal + " "
      }
      else if (count < listLength) {
        result = result + ", "
      }
      else {
        result = result + postList
      }
    }
    return (result)
  ]]></function>
  <function name="GetDisplayAlias" parameters="obj" type="string">
    if (HasString(obj, "alias")) {
      result = obj.alias
    }
    else {
      result = obj.name
    }
    return (result)
  </function>
  <function name="GetDisplayName" parameters="obj" type="string">
    return (GetDisplayNameLink(obj, "", null))
  </function>
  <function name="GetDisplayNameLink" parameters="obj, type, verbs" type="string"><![CDATA[
    result = GetTaggedName(obj, type, verbs)
    if (not GetBoolean(obj, "usedefaultprefix")) {
      if (obj.prefix = null) {
        prefix = ""
      }
      else {
        prefix = obj.prefix
      }
    }
    else if (type = "exit") {
      prefix = ""
    }
    else {
      prefix = GetDefaultPrefix(obj)
    }
    if (LengthOf(prefix)>0) {
      prefix = prefix + " "
    }
    result = prefix + result
    if (not GetBoolean(obj, "usedefaultprefix") and HasString(obj, "suffix")) {
      result = result + " " + obj.suffix
    }
    return (result)
  ]]></function>
  <function name="GetTaggedName" parameters="obj, type, verbs" type="string"><![CDATA[
    alias = GetDisplayAlias(obj)
    if (not game.enablehyperlinks) {
      tag = ""
    }
    if (not type = "") {
      result = "<object"
      if (verbs <> null) {
        result = result + " verbs='" + Join(verbs, "/") + "'"
      }
      result = result + ">" + alias + "</object>"
    }
    else {
      result = alias
    }
    return (result)
  ]]></function>
  <function name="EnableTimer" parameters="timer">
    timer.enabled = true
    timer.trigger = game.timeelapsed + timer.interval
  </function>
  <function name="DisableTimer" parameters="timer">
    timer.enabled = false
  </function>
  <function name="SetTimerInterval" parameters="timer, interval">
    timer.interval = interval
  </function>
  <function name="SetTimerScript" parameters="timer, script">
    timer.script = script
  </function>
  <function name="SetTimeout" parameters="interval, script">
    timername = GetUniqueElementName("timeout")
    create timer (timername)
    timer = GetTimer(timername)
    SetTimerInterval (timer, interval)
    timer.timeoutscript = script
    SetTimerScript (timer) {
      this.enabled = false
      invoke (this.timeoutscript)
      destroy (this.name)
    }
    EnableTimer (timer)
  </function>
  <function name="Pause" parameters="interval">
    request (Pause, ToString(interval * 1000))
  </function>
  <function name="RunTurnScripts">
    foreach (turnscript, AllTurnScripts()) {
      if (GetBoolean(turnscript, "enabled")) {
        inscope = false
        if (turnscript.parent = game or turnscript.parent = null) {
          inscope = true
        }
        else {
          if (Contains(turnscript.parent, player)) {
            inscope = true
          }
        }
        if (inscope) {
          do (turnscript, "script")
        }
      }
    }
  </function>
  <function name="EnableTurnScript" parameters="turnscript">
    turnscript.enabled = true
  </function>
  <function name="DisableTurnScript" parameters="turnscript">
    turnscript.enabled = false
  </function>
  <function name="SetTurnScript" parameters="turnscript, script">
    turnscript.script = script
  </function>
  <function name="SetTurnTimeout" parameters="turncount, script"><![CDATA[
    turnscriptname = GetUniqueElementName("turnscript")
    create turnscript (turnscriptname)
    turnscript = GetObject(turnscriptname)
    turnscript.turncount = 0
    turnscript.triggerturncount = turncount
    turnscript.timeoutscript = script
    SetTurnScript (turnscript) {
      this.turncount = this.turncount + 1
      if (this.turncount >= this.triggerturncount) {
        this.enabled = false
        invoke (this.timeoutscript)
        destroy (this.name)
      }
    }
    EnableTurnScript (turnscript)
  ]]></function>
  <function name="UpdateStatusAttributes">
    status = AddStatusAttributesForElement("", game)
    status = AddStatusAttributesForElement(status, player)
    request (SetStatus, status)
  </function>
  <function name="AddStatusAttributesForElement" parameters="status, element" type="string"><![CDATA[
    if (element.statusattributes <> null) {
      foreach (attr, element.statusattributes) {
        if (LengthOf(status) > 0) {
          status = status + "\n"
        }
        status = status + FormatStatusAttribute(attr, GetAttribute(element, attr), StringDictionaryItem(element.statusattributes, attr))
      }
    }
    return (status)
  ]]></function>
  <function name="FormatStatusAttribute" parameters="attr, value, format" type="string">
    if (LengthOf(format) = 0) {
      return (CapFirst(attr) + ": " + value)
    }
    else {
      if (TypeOf(value) = "int" or TypeOf(value) = "double") {
        value = ToString(value)
      }
      return (Replace(format, "!", value))
    }
  </function>
  <function name="SetFramePicture" parameters="filename"><![CDATA[
    if (game.useframe) {
      request (RunScript, "setFramePicture; " + GetFileURL(filename))
    }
    else {
      msg ("<color color=\"red\"><b>ERROR: The static picture frame is not enabled. You can enable this from the Display tab of the Game editor.</b></color>")
    }
  ]]></function>
  <function name="ClearFramePicture">
    request (RunScript, "clearFramePicture")
  </function>
  <function name="ClearScreen">
    request (ClearScreen, "")
  </function>
  <function name="SetForegroundColour" parameters="colour">
    request (Foreground, colour)
    game.defaultforeground = colour
  </function>
  <function name="SetBackgroundColour" parameters="colour">
    request (Background, colour)
    game.defaultbackground = colour
  </function>
  <function name="SetFontName" parameters="font">
    request (FontName, font)
    game.defaultfont = font
  </function>
  <function name="SetFontSize" parameters="size">
    request (FontSize, ToString(size))
    game.defaultfontsize = size
  </function>
  <function name="PrintCentered" parameters="text"><![CDATA[
    msg ("<align align=\"center\">" + text + "</align>")
  ]]></function>
  <function name="ShowYouTube" parameters="id">
    request (RunScript, "AddYouTube; " + id)
  </function>
  <function name="ShowVimeo" parameters="id">
    request (RunScript, "AddVimeo; " + id)
  </function>
  <function name="WaitForKeyPress">
    request (Wait, "")
  </function>
  <function name="DisplayHttpLink" parameters="text, url, https"><![CDATA[
    if (https) {
      url = "https://" + url
    }
    else {
      url = "http://" + url
    }
    msg ("<a href=\"" + url + "\">" + text + "</a>")
  ]]></function>
  <function name="DisplayMailtoLink" parameters="text, url"><![CDATA[
    url = "mailto:" + url
    msg ("<a href=\"" + url + "\">" + text + "</a>")
  ]]></function>
  <function name="InitInterface">
    request (FontName, game.defaultfont)
    request (FontSize, ToString(game.defaultfontsize))
    request (Background, game.defaultbackground)
    request (Foreground, game.defaultforeground)
    request (LinkForeground, game.defaultlinkforeground)
    request (SetCompassDirections, Join(game.compassdirections, ";"))
    request (SetInterfaceString, "InventoryLabel=Inventario")
    request (SetInterfaceString, "PlacesObjectsLabel=Lugares y Objetos")
    request (SetInterfaceString, "CompassLabel=Brújula")
    request (SetInterfaceString, "InButtonLabel=Entrar")
    request (SetInterfaceString, "OutButtonLabel=Salir")
    request (SetInterfaceString, "EmptyListLabel=(vacío)")
    request (SetInterfaceString, "NothingSelectedLabel=(nada seleccionado)")
    if (game.useframe) {
      request (ClearScreen, "")
      insert ("Frame.htm")
      request (RunScript, "beginUsingTextFrame")
    }
    if (game.showpanes) {
      request (Show, "Panes")
    }
    else {
      request (Hide, "Panes")
    }
  </function>
  <function name="StartGame">
    UpdateStatusAttributes
    if (HasScript(game, "start")) {
      do (game, "start")
    }
    UpdateStatusAttributes
    if (game.displayroomdescriptiononstart) {
      invoke (player.changedparent)
    }
    UpdateStatusAttributes
  </function>
  <function name="RandomChance" parameters="percentile" type="boolean"><![CDATA[
    return (GetRandomInt(0,100) < percentile)
  ]]></function>
  <function name="SetObjectFlagOn" parameters="object, flag">
    set (object, flag, true)
  </function>
  <function name="SetObjectFlagOff" parameters="object, flag">
    set (object, flag, false)
  </function>
  <function name="IsSwitchedOn" parameters="object" type="boolean">
    return (GetBoolean(object, "switchedon"))
  </function>
  <function name="MoveObject" parameters="object, parent">
    object.parent = parent
  </function>
  <function name="RemoveObject" parameters="object">
    object.parent = null
  </function>
  <function name="HelperOpenObject" parameters="object">
    object.isopen = true
  </function>
  <function name="HelperCloseObject" parameters="object">
    object.isopen = false
  </function>
  <function name="CloneObject" parameters="object" type="object">
    newobject = Clone(object)
    if (not HasString(object, "alias")) {
      newobject.alias = object.name
    }
    return (newobject)
  </function>
  <function name="CloneObjectAndMove" parameters="object, newparent" type="object">
    newobject = CloneObject(object)
    newobject.parent = newparent
    return (newobject)
  </function>
  <function name="LockExit" parameters="exit">
    exit.locked = true
  </function>
  <function name="UnlockExit" parameters="exit">
    exit.locked = false
  </function>
  <javascript src="Frame.js" />
</asl>