<!--Saved by Quest 5.4.4812.28144-->
<asl version="540">
  <include ref="English.aslx" />
  <include ref="Core.aslx" />
  <include ref="ConvLib (1).aslx" />
  <game name="WAKE">
    <gameid>d73473bf-8d58-49aa-9aa4-a019034de38c</gameid>
    <version>1.05</version>
    <firstpublished>2013</firstpublished>
    <subtitle>Evolution through Extinction</subtitle>
    <author>Tim Sibiski</author>
    <category>Sci-Fi</category>
    <description><![CDATA[<br/>]]></description>
    <autodescription />
    <defaultfont>'Trebuchet MS', Helvetica, sans-serif</defaultfont>
    <firstname>Name</firstname>
    <defaultbackground>White</defaultbackground>
    <attr name="autodescription_youcango" type="int">4</attr>
    <attr name="autodescription_description" type="int">3</attr>
    <attr name="autodescription_description_newline" type="boolean">false</attr>
    <attr name="autodescription_youcansee_newline" type="boolean">false</attr>
    <defaultfontsize type="int">12</defaultfontsize>
    <start type="script"><![CDATA[
      PrintCentered ("<b><font size=\"14\" color=\"black\">WAKE</font></b><br/><b><font size=\"6\" color=\"black\">\"Evolution Through Extinction\"</font></b>")
      msg ("<br/>by Timothy Sibiski (aka \"Asyranok\")")
      msg ("<br/>Demo version 2.2; Published 2013 ")
      msg ("<br/><b>Genre:</b> Science Fiction")
      msg ("<b>Difficulty:</b> Casual and Challenging pathways (both with unique story aspects and experience). Type command \"Help\" at any point to get a list of commands or general advice.")
      msg ("<b>Category:</b> Puzzle and Hidden Object")
      msg ("<br/><br/><i> There are native issues with timed-scripts in the online version. Please play the downloaded version for the full experience. If you do play the online version, please choose \"Skip Intro\" below. Thanks, and enjoy!</i><br/>")
      menulist = NewStringList()
      list add (menulist, "Play Intro")
      list add (menulist, "Skip Intro")
      ShowMenu ("Would you like to play the intro sequence, or skip it?", menulist) {
        if (result = "Play Intro") {
          msg ("<i>You've chosen to play the intro. Please press any key to continue.)</i>")
          wait {
            ClearScreen
            play sound ("TheThing.mp3", false, false)
            msg ("     Extinction isn't always the end.")
            SetTimeout (3) {
              msg ("<br/>    Sometimes, it's a new beginning.")
              SetTimeout (3) {
                ClearScreen
                msg ("You are the remnant of a once-vast civilization that nearly broke the barriers of endless space and limitless energy. ")
                SetTimeout (4) {
                  msg ("<br/>But what took humanity fifty thousand years to create, was brought to its knees in a matter of months.")
                  SetTimeout (4) {
                    msg ("<br/>Now, nothing more than the derelict machinery and twisted husks of cities remain standing.<br/>")
                    picture ("Wake.JPG")
                    msg ("<i>(Placeholder song and picture credits. Final picture and song will be original works.)</i>")
                    msg ("<i>Picture credit goes to History Channel show, \"Life After People\".</i>")
                    msg ("<i>Song is \"The Thing 2011 Theme\". All rights go to Universal Studios.</i>")
                    wait {
                      stop sound
                      ClearScreen
                      msg ("<b><font size=\"8\" color=\"midnightblue\">Part One:</font></b>")
                      msg ("-Introduction-")
                      msg ("<br/>\"The reason to live, is to live life for a reason. I don't believe that humanity is searching for meaning so much as assent for our glorious and immutable impact on all that ever was and ever shall be.\"<br/><i>-Dr. Fredrik Montaux, during an interview about his reasearch on telomere degredation and its possible impact on the concept of immortality</i>")
                      msg ("<br/><br/><i>(Press any key to continue.)</i>")
                      wait {
                        ClearScreen
                        msg ("Your vision is blurry, but things soon come into focus. A sign says, \"Hyper-stasis Room\". The walls are a dull grey. Metal beds with glass canopies lie in two rows, ending at a collapsed wall, where rubble has consumed the rest of the machines.<br/><br/>Suddenly, you notice that you're not alone. Two figures stand nearby, watching you intently. You are not initially sure if your eyes are playing tricks on you, but these creatures are clearly not human. Their deep, black eyes, like two puddles of oil, study your every move. An amphibious complexion displays their vibrant skin colors in shockingly complex patterns, like an octopus in a threat display.<br/>")
                        msg ("<br/><br/><i>(Press any key to continue.)</i>")
                        wait {
                          ClearScreen
                          msg ("One of the creatures breaks formation, and approaches you. You raise your arm and slide backwards in your stasis pod, in a feeble attempt to retreat. It begins interacting with a device on its wrist. A beam of light eminating from the object casts a wide net over your body, sliding from your toes to your head. <br/><br/>\"Hello. You can call me 'Duffy',\" the creature says in perfect English. <br/><br/>\"Don't be afraid. We're here to learn; not hurt,\" the second being steps forward and says.\"Ah, my name is Ziggy, by the way. What is yours?\" ")
                          msg ("<br/>\"I can't really remember my last name, but I think my first name was...\"")
                          PrintCentered ("<br/><br/><br/><i><b>(Type your first name)</b></i>")
                          get input {
                            player.alias = result
                            ClearScreen
                            msg ("Ziggy says, \"It is good to meet you, " + player.alias + "! \" ")
                            msg ("<br/><i>(Press any key to continue.)</i>")
                            wait {
                              ClearScreen
                              MakeObjectVisible (ZiggyIntro)
                              MakeObjectVisible (DuffyIntro)
                              MakeObjectVisible (BrokenStasisPod)
                              MakeObjectVisible (WarningSign)
                              MakeObjectVisible (EnergyWall)
                              MoveObject (player, HyperStasisRoom1)
                            }
                          }
                        }
                      }
                    }
                  }
                }
              }
            }
          }
        }
        else {
          msg ("<i> You've chosen to skip the introduction. Please press any key to continue.</i>")
          wait {
            stop sound
            ClearScreen
            msg ("<b><font size=\"8\" color=\"midnightblue\">Part One:</font></b>")
            msg ("-Introduction-")
            msg ("<br/>\"The reason to live, is to live life for a reason. I don't believe that humanity is searching for meaning so much as assent for our glorious and immutable impact on all that ever was and ever shall be.\"<br/><i>-Dr. Fredrik Montaux, during an interview about his reasearch on telomere degredation and its possible impact on the concept of immortality</i>")
            msg ("<br/><br/><i>(Press any key to continue.)</i>")
            wait {
              ClearScreen
              msg ("Your vision is blurry, but things soon come into focus. A sign says, \"Hyper-stasis Room\". The walls are a dull grey. Metal beds with glass canopies lie in two rows, ending at a collapsed wall, where rubble has consumed the rest of the machines.<br/><br/>Suddenly, you notice that you're not alone. Two figures stand nearby, watching you intently. You are not initially sure if your eyes are playing tricks on you, but these creatures are clearly not human. Their deep, black eyes, like two puddles of oil, study your every move. An amphibious complexion displays their vibrant skin colors in shockingly complex patterns, like an octopus in a threat display.<br/>")
              msg ("<br/><br/><i>(Press any key to continue.)</i>")
              wait {
                ClearScreen
                msg ("One of the creatures breaks formation, and approaches you. You raise your arm and slide backwards in your stasis pod, in a feeble attempt to retreat. It begins interacting with a device on its wrist. A beam of light eminating from the object casts a wide net over your body, sliding from your toes to your head. <br/><br/>\"Hello. You can call me 'Duffy',\" the creature says in perfect English. <br/><br/>\"Don't be afraid. We're here to learn; not hurt,\" the second being steps forward and says.\"Ah, my name is Ziggy, by the way. What is yours?\" ")
                msg ("<br/>\"I can't really remember my last name, but I think my first name was...\"")
                PrintCentered ("<br/><br/><br/><i><b>(Type your first name)</b></i>")
                get input {
                  player.alias = result
                  ClearScreen
                  msg ("Ziggy says, \"It is good to meet you, " + player.alias + "! \" ")
                  msg ("<br/><i>(Press any key to continue.)</i>")
                  wait {
                    ClearScreen
                    MakeObjectVisible (ZiggyIntro)
                    MakeObjectVisible (DuffyIntro)
                    MakeObjectVisible (BrokenStasisPod)
                    MakeObjectVisible (WarningSign)
                    MakeObjectVisible (EnergyWall)
                    MoveObject (player, HyperStasisRoom1)
                  }
                }
              }
            }
          }
        }
      }
    ]]></start>
  </game>
  <object name="HyperStasisRoom1">
    <inherit name="editor_room" />
    <alias>Hyper-stasis room</alias>
    <usedefaultprefix />
    <descprefix>You are in</descprefix>
    <objectslistprefix>with</objectslistprefix>
    <description type="script"><![CDATA[
      msg ("There is only one exit in this room, which is blocked by a deep-blue energy of some kind. <br/><br/>You struggle to get on your feet, but Ziggy notices your disorientation, and helps you as your body adjusts to standing for the first time in decades. <br/><br/>When you seem to get your bearings, Ziggy goes to sit by Duffy. They begin discussing something in the strangest manner; with a series of guttural yelps and clicks. <br/><br/><i>(To proceed naturally from the Hyper-stasis Room to the next area, the user must initiate dialogue with Duffy. If you do not wish to read through the dialogue sequence, you may enter the command, \"Skip\". Be aware that this will cause you to miss out on important elements of the story.)</i>")
    ]]></description>
    <object name="ZiggyIntro">
      <inherit name="editor_object" />
      <inherit name="namedfemale" />
      <inherit name="talkingchar" />
      <alias>Ziggy</alias>
      <scenery type="boolean">false</scenery>
      <look>Ziggy seems to be the female, with the little reference you have to go by. Ziggy looks virtually identical to Duffy, with more blue and teal colors whisking down her body. She appears to be entirely naked, much like Duffy, but she carries no devices on her body. Her gecko-like hand has three digits, and is significantly larger than her face. She uses these hands as part of her body language, unlike Duffy. Despite being virtually identical to her counterpart, she feels more open and trustworthy to you.</look>
      <displayverbs type="stringlist">
        <value>Look at</value>
        <value>Talk to</value>
      </displayverbs>
      <visible type="boolean">false</visible>
      <object name="ZiggyIntroConvoPurpose">
        <inherit name="editor_object" />
        <inherit name="topic" />
        <alias>Who are you?</alias>
        <scenery />
        <talk type="script">
          ClearScreen
          msg ("\"Swifts? you say. \"That answers the 'what'. But I'm also curious; who exactly are you?")
          wait {
            ClearScreen
            msg ("Ziggy smiled and says, \"We are expeditionaries. I am a xenobiologist and physician. Duffy here is an engineer and security specialist. Our mission was... originally... just to find out if this planet could support our species, should we want to colonize it. That directive changed the moment we saw the ruins; and was scrapped the moment we found you. You are... amazing.\"")
          }
        </talk>
      </object>
      <object name="ZiggyWhatAreYou">
        <inherit name="editor_object" />
        <inherit name="startingtopic" />
        <displayverbs type="stringlist">
          <value>Look at</value>
          <value>Speak to</value>
        </displayverbs>
        <alias>So, you are from another planet...?</alias>
        <nowshow type="stringlist">
          <value>ZiggyIntroConvoPurpose</value>
        </nowshow>
        <scenery />
        <talk type="script">
          ClearScreen
          msg ("\"Sorry to be so blunt, but... what exactly are you and Duffy?\" You ask.")
          wait {
            ClearScreen
            msg ("\"I totally understand!\" she replies. \"And you can call us 'Swifts'. We come from a distant solar system. We've been sweeping the stars for signs of life for... well, for a long time. ")
          }
        </talk>
      </object>
      <object name="ZiggyConvoWall">
        <inherit name="editor_object" />
        <inherit name="topic" />
        <alias>Why the energy wall?</alias>
        <scenery />
        <hideafter />
        <talk type="script">
          ClearScreen
          msg ("\"Is that an energy wall?\" you ask.")
          wait {
            ClearScreen
            msg ("\"Ah, yes,\" Ziggy says. \"It is beautiful isn't it? If I was locked somewhere, I'd rather be locked in by that - as opposed to a dull old door.\"")
            wait {
              ClearScreen
              msg ("\"Did you expect me to run?\" you ask.")
              wait {
                ClearScreen
                msg ("\"Not at all,\" Ziggy replies. \"It isn't there to keep you in. It's there to keep things out.\"")
                wait {
                  ClearScreen
                  msg ("For a moment, you wonder what she means by 'keep things out', but you are too light-headed to press the issue.")
                }
              }
            }
          }
        </talk>
      </object>
    </object>
    <object name="DuffyIntro">
      <inherit name="editor_object" />
      <inherit name="namedmale" />
      <inherit name="talkingchar" />
      <alias>Duffy</alias>
      <scenery type="boolean">false</scenery>
      <look>Short of knowing alien physiology and sexual dimorphism, Duffy seems to be best described as male. His physical appearance is virtually identical to Ziggy, save for a few differences in coloration. He is naked, as far as you can tell. The only things he is wearing are his wrist device, and some sort of mechanical backpack with metal strapping resting over his shoulders. His coloration has more reds and purples that his counterpart. His movements are deliberate and succinct.</look>
      <displayverbs type="stringlist">
        <value>Look at</value>
        <value>Talk to</value>
      </displayverbs>
      <nowshow type="stringlist">
        <value>DuffyJustOne</value>
      </nowshow>
      <inventoryverbs type="stringlist">
        <value>Look at</value>
      </inventoryverbs>
      <visible type="boolean">false</visible>
      <talk type="script">
        msg ("")
      </talk>
      <object name="DuffyEnglishSpeaking">
        <inherit name="editor_object" />
        <inherit name="startingtopic" />
        <alias>You speak English?</alias>
        <scenery />
        <nowshow type="stringlist">
          <value>DuffyJustOne</value>
        </nowshow>
        <talk type="script"><![CDATA[
          ClearScreen
          msg ("<br/>You fumble for words as you ask, \"How can I... do you... understand?\" ")
          msg ("<br/>Duffy seems to immediately know what is perplexing you. \"This...,\" he says as he points to the device on his wrist. \"It scans your body, determining your way of communicating. It slightly alters your perception of reality. We are talking in our language, but this is pursuading your mind to interpret it in a form that you can understand.\" <br/><br/>\"Sanjaan Makala!\" Ziggy says as her neck begins to pulsate, possibly from increased circulation of whatever fluids she might call 'blood'. <br/><br/>Duffy points out, \"As you can see, the device is not perfect. 'Sanjaan Makala' does not have an acceptable translation. Instead, this device simply tried to make a word using your alphabet.\" <br/><br/>\"This is the greatest discovery in our specie's history,\" Ziggy says, seemingly trying to contain excitement by covering her slim, curvy face, and those dark, dark eyes. <br/><br/>Duffy finally turns his head to look at her. Their body language is completely alien, but somehow familiar. You aren't sure if this, too, is the work of Duffy's device, but you detect an expression of incredulity directed at Ziggy. \"It's just one,\" he mutters. <br/><br/>\"And<b> he's</b> alive!\" she replies. ")
          wait {
            ClearScreen
            do (HyperStasisRoom1, "description")
          }
        ]]></talk>
      </object>
      <object name="DuffyJustOne">
        <inherit name="editor_object" />
        <inherit name="topic" />
        <alias>I am just one...?</alias>
        <scenery />
        <talk type="script"><![CDATA[
          ClearScreen
          msg ("<br/>You ask, \"Wait. What do you mean by, 'I am just one'?\" ")
          msg ("<br/>Duffy replies, \"You are the only other known sapient species in this galaxy. You are a very special find.\"<br/><br/>Ziggy adds, \"What he means to say is that you are a very rare individual. Your life is special to all of us.\" <br/>")
          wait {
            ClearScreen
            msg ("\"I still don't understand,\" you press. \"Rare individual?\" ")
            wait {
              ClearScreen
              msg ("Ziggy stares at Duffy for a moment, before a more sombering expression appears on her face. \"You're unaware? You are the sole remaining representative of your species. Preliminary accounts suggest that humans went extinct over 100 years ago, at least. <br/><br/>\"Does this mean that you were in stasis before the extinction event began?\" Duffy asks. ")
              wait {
                ClearScreen
                msg ("\"No, no,\" you say. \"I mean... I don't know. I don't remember much of anything!\"")
                wait {
                  ClearScreen
                  msg ("\"I feared this might happen,\" Duffy says. \"This stasis pod's design is inferior. It seemed likely that there'd be side-effects to long term use. My initial scans suggest that memories associated with emotions may be most effected. Language and skills remain intact. Memories of your personal life could be inhibited.\"<br/><br/>Ziggy asks, \"Are these effects permanent?\"<br/><br/>\"Nothing is for certain. New physiology, new set of rules to explore.\"")
                  wait {
                    ClearScreen
                    msg ("\"This is crazy,\" you hiss under a deep breath. \"I can't... I...\"")
                    msg ("<br/>The room becomes increasingly dark, and your senses dull, as you try to find your words.")
                    wait {
                      ClearScreen
                      msg ("\"What's wrong?\" you think you hear Ziggy ask, through the increasing haze in your head.")
                      msg ("<br/>Duffy replies, \"He must be losing 'consc'...\" <br/><br/>Your brain seems to stumble, making the words sound like a low baritone mess.<br/><br/>\"His body has been.. .for decades... 'ould' be fine.\"")
                      wait {
                        ClearScreen
                        msg ("You finallly succumb and black out.")
                        wait {
                          MoveObject (player, MedicalStation)
                        }
                      }
                    }
                  }
                }
              }
            }
          }
        ]]></talk>
      </object>
    </object>
    <object name="BrokenStasisPod">
      <inherit name="editor_object" />
      <inherit name="container_open" />
      <alias>broken stasis pod</alias>
      <look>This stasis pod is broken open. The person inside is long-dead. You notice a book or journal at the skeleton's feet.</look>
      <close type="boolean">false</close>
      <open type="boolean">false</open>
      <transparent />
      <hidechildren />
      <listchildren />
      <listchildrenprefix>The pod contains</listchildrenprefix>
      <displayverbs type="stringlist">
        <value>Look at</value>
      </displayverbs>
      <visible type="boolean">false</visible>
      <object name="Skeleton1">
        <inherit name="editor_object" />
        <inherit name="male" />
        <look>The body is battered. It looks like a large piece of debris collapsed through the pod and shattered his ribs. He must have died instantly.</look>
        <displayverbs type="stringlist">
          <value>Look at</value>
        </displayverbs>
        <alias>skeleton</alias>
      </object>
      <object name="Journal1">
        <inherit name="editor_object" />
        <alias>deteriorating journal</alias>
        <visible />
        <look>There is a old, deteriorating journal by the skeleton's feet. It's falling apart. Some of the pages might be legible.</look>
        <take />
        <alt type="stringlist">
          <value>book</value>
          <value>journal</value>
        </alt>
        <takemsg>You take the old journal. Pieces of it crumble off in your hand.</takemsg>
        <dropmsg>You go to drop the journal, but it falls apart. Ashes to ashes; dust to dust.</dropmsg>
        <alreadyread type="boolean">false</alreadyread>
        <inventoryverbs type="stringlist">
          <value>Look at</value>
          <value>Drop</value>
        </inventoryverbs>
        <ontake type="script">
          Journal1.alreadyread = True
        </ontake>
        <ondrop type="script">
          Journal1.alreadyread = False
          RemoveObject (Journal1)
        </ondrop>
      </object>
    </object>
    <object name="WarningSign">
      <inherit name="editor_object" />
      <displayverbs type="stringlist">
        <value>Look at</value>
      </displayverbs>
      <take type="boolean">false</take>
      <look><![CDATA[There's a sign on the nearby wall. It says, <br/><br/>"WARNING: Effects of long-term hyper stasis are currently unknown. Use of these devices assumes both security clearance and the signing of associated waivers. Unauthorized useage, or any other use of this technology, is a felony under artcle 57-9B of the Bio-stasis Technologies Act."]]></look>
      <alias>warning sign</alias>
      <visible type="boolean">false</visible>
    </object>
    <object name="EnergyWall">
      <inherit name="editor_object" />
      <alias>wall of energy</alias>
      <displayverbs type="stringlist">
        <value>Look at</value>
      </displayverbs>
      <visible type="boolean">false</visible>
      <look type="script">
        msg ("An energy-wall of some type is covering the only exit from this room. You assume it is alien technology, but why they erected it is the real question. You aren't exactly capable of running away at the moment.")
        do (ZiggyConvoWall, "show")
      </look>
    </object>
  </object>
  <object name="MedicalStation">
    <inherit name="editor_room" />
    <alias>Makeshift alien medical station</alias>
    <visitedvoid type="boolean">false</visitedvoid>
    <description type="script"><![CDATA[
      if (MedicalStation.visitedvoid = True) {
        msg ("<br/>After examining your surroundings for a moment, you are sure that you've returned to the Medical Station, and that nothing has changed. However, you find something cold in your pocket. You reach inside and pull out a pulsing blue orb, around the size of a marble. It wasn't in your pocket before you touched the strange device. You aren't sure what it does, but it might be worth keeping.")
        MedicalStation.visitedvoid = False
      }
      else {
        msg ("<br/>This appears to be some sort of medical structure. There are strange beds that resemble gourneys. Equipment with screens, that may be vital readings, sit near each gourney. A crane arm holds some sort of laser tool at a reasonable distance above your head. <br/><br/>The walls appear to be made of a dense, metallic fabric, spread loosely enough for folds and creases to form.")
      }
    ]]></description>
    <beforefirstenter type="script"><![CDATA[
      ClearScreen
      msg ("<b><font size=\"8\" color=\"midnightblue\">Part 2:</font></b><br/>-As It All Sinks In-<br/><br/>\"Everything burns. Even my soul is on fire. Is this what it feels like -  to play God?<br/><i>-Quote written in a partially-preserved journal.</i>")
      if (player.skip = True) {
        wait {
          ClearScreen
          MakeObjectVisible (Ziggy2)
          MakeObjectVisible (Duffy2)
          MakeObjectVisible (Alien Supply Crate)
          MakeObjectVisible (laser)
          MakeObjectVisible (strange device)
          MakeExitVisible (Outside of Medical Station)
        }
      }
      else {
        wait {
          ClearScreen
          msg ("You have awoken in what appears to be some sort of medical station. The aliens, Ziggy and Duffy, stand nearby. Ziggy is staring at you from a sitting position on an adjacent gourney. She jumps to her feet and makes some sort of gesture with her hand, spreading it over her chest, and then placing it as a fist over her eye. <br/><br/>\"You are refreshed, no?\" she says, with what can best be described as a smile. <br/><br/>\"How do you feel, human?\" Duffy adds. ")
          wait {
            ClearScreen
            msg ("\"Horrible,\" you reply.")
            wait {
              ClearScreen
              msg ("\"Do you need more rest?\" Ziggy asks.")
              wait {
                ClearScreen
                msg ("\"No!,\" you almost shout it. \"I mean; what I need is answers.\"")
                wait {
                  ClearScreen
                  msg ("\"I'm afraid that you already know about as much as we do,\" Ziggy replies. \"We haven't been on this planet long. Your stasis chamber was emitting unnatural energy. We came to investigate. That's when we began to see the extent of... the ruins.\"")
                  wait {
                    ClearScreen
                    msg ("\"What's happened? I need to see!\" You say, struggling to your feet. You take a few moments to regain your balance as you head directly for the door - but Duffy stops you.<br/><br/>\"Get out of my way,\" you shout.")
                    wait {
                      ClearScreen
                      msg ("\"Sit down! You are not leaving here until we allow it,\" Duffy shouts back. Despite his slender frame and slight build, he has an imposing stance, forcing you to back off some. Not only that, but decades of sleep have rendered you feeling particularly weak.<br/><br/>\"And we <b>will</b> allow it,\" Ziggy continues. \"All I ask is that you let us accompany you. We want answers too. We can help one another. Even protect one another.\"")
                      wait {
                        ClearScreen
                        msg ("\"Because I am precious?\" you reply.")
                        wait {
                          ClearScreen
                          msg ("\"No,\" Ziggy says, reaching out in a surprisingly human gesture; putting her hand on your shoulder. \"Because you deserve answers. And you are one of us, as far as I'm concerened.\"")
                          wait {
                            ClearScreen
                            msg ("You say, \"Okay... I will do what I need to do to find answers. If you want to watch over me - you'll have to keep up.\"")
                            wait {
                              ClearScreen
                              MakeObjectVisible (Ziggy2)
                              MakeObjectVisible (Duffy2)
                              MakeObjectVisible (Alien Supply Crate)
                              MakeObjectVisible (laser)
                              MakeObjectVisible (strange device)
                              MakeExitVisible (Outside of Medical Station)
                            }
                          }
                        }
                      }
                    }
                  }
                }
              }
            }
          }
          player.skip = True
        }
      }
    ]]></beforefirstenter>
    <object name="Ziggy2">
      <inherit name="editor_object" />
      <inherit name="namedfemale" />
      <inherit name="talkingchar" />
      <alias>Ziggy</alias>
      <attr name="Key_Asked" type="boolean">false</attr>
      <look>Ziggy is in the corner of the room, interfacing with a holographic computer device. She may be trying to type a message or log out, before we leave the station.</look>
      <visible type="boolean">false</visible>
      <ask type="scriptdictionary">
        <item key="crate key">
          if (not Got(CrateKey)) {
            if (Ziggy2.Key_Asked = False) {
              msg ("\"Do you know what's in that crate over there?\" you ask.")
              wait {
                ClearScreen
                msg ("\"It's a bunch of supplies,\" Ziggy says, before flashing what looks like another smile. \"Actually, you should start rummaging through, and pick out a few things that you think it might behoove us to take.\"")
                wait {
                  ClearScreen
                  msg ("\"Ok. But where's the key?\"")
                  wait {
                    ClearScreen
                    msg ("\"Ah, yes. That would help. I'm pretty sure that Duffy has the key. Check with him.\" she says, before turning back to the furiously-active computer screen behind her.")
                    Ziggy2.Key_Asked = True
                  }
                }
              }
            }
            else if (Ziggy2.Key_Asked = True) {
              msg ("You ask, \"Do you know where the key to that crate is?\"")
              wait {
                ClearScreen
                msg ("\"You're so silly. You already asked me that. Duffy should have it. I'll chock that up to over a hundred years in a stasis pod,\" Ziggy says with a laugh.")
              }
            }
          }
          else if (Got(CrateKey)) {
            msg ("You ask, \"Do you know where the key to that crate is?\"")
            wait {
              ClearScreen
              msg ("\"You're so silly. You already have it! I'll chock that up to over a hundred years in a stasis pod,\" Ziggy says with a laugh.")
            }
          }
        </item>
      </ask>
      <object name="WhatIsWithDuffy">
        <inherit name="editor_object" />
        <inherit name="startingtopic" />
        <hideafter type="boolean">false</hideafter>
        <displayverbs type="stringlist">
          <value>Look at</value>
        </displayverbs>
        <alt type="stringlist">
          <value>Speak to</value>
        </alt>
        <alias>What's with Duffy?</alias>
        <talk type="script"><![CDATA[
          ClearScreen
          msg ("With Duffy currently using a pretty loud tool, you ask Ziggy, \"Why's Duffy so... blunt.?\"")
          wait {
            ClearScreen
            msg ("\"Oh yes! I did want to apologize on behalf of him. He has always been like that since the day I met him. He will warmto you in no-time. Just, please, be patient with him.\" Ziggy wraps her arms around you for a moment, seemingly giving you a hug. <br/><br/>Again, you wonder if the device of Duffy's is altering your perception, or maybe Ziggy is learning these expressions, and acting on them, just for your sake. Maybe, in some fluke way, these aliens developed the similar behavoirs that mean the same thing.<br/><br/>You do realize though, that regardless of the reason, you could use a hug after all that has happened today.")
          }
        ]]></talk>
      </object>
    </object>
    <object name="Duffy2">
      <inherit name="editor_object" />
      <inherit name="namedmale" />
      <inherit name="talkingchar" />
      <alias>Duffy</alias>
      <displayverbs type="stringlist">
        <value>Look at</value>
        <value>Speak to</value>
      </displayverbs>
      <attr name="Ask_What" type="boolean">false</attr>
      <visible type="boolean">false</visible>
      <look type="script">
        if (Duffy2.Ask_What = False) {
          msg ("Duffy is working on a small bot, I believe. He is near the exit, which I assume leads outside - to the ruins. I'm not excited to see what's happened to Earth since I fell asleep, but I need to; I need to find out what happened. ")
        }
        else if (Duffy2.Ask_What = True) {
          msg ("Duffy told me that he is making final repairs to a medical drone that would assume maintenance responsibilities for the station while we are gone. He is near the exit, which I assume leads outside - to the ruins. I'm not excited to see what's happened to Earth since I fell asleep, but I need to; I need to find out what happened. ")
        }
      </look>
      <speak type="script">
        if (this.alias = null) {
          error ("ERROR: Trying to have conversation with talkingchar with no alias: " + this.name)
        }
        ol = NewObjectList ()
        sl = NewStringList ()
        foreach (obj, GetDirectChildren (this)) {
          if (DoesInherit (obj, "topic") and GetBoolean (obj, "display")) {
            if (obj.alias = null) {
              error ("ERROR: Found topic with no alias: " + obj.name)
            }
            list add (ol, obj)
            list add (sl, obj.alias)
          }
        }
        if (not ListCount (sl) = 0) {
          show menu ("Talk to " + this.alias + " about...", sl, true) {
            if (not result = null) {
              this.path_pause_once = true
              if (this.nevermet) {
                if (HasScript (this, "greet")) {
                  do (this, "greet")
                }
                this.nevermet = false
              }
              foreach (obj, ol) {
                if (obj.alias = result) {
                  do (obj, "topictalk")
                }
              }
            }
          }
        }
        else {
          msg (DynamicTemplate("NothingToTalkAbout", this))
        }
      </speak>
      <ask type="scriptdictionary">
        <item key="supply crate key"><![CDATA[
          ClearScreen
          msg ("You ask, \"That crate is locked. What's inside?\"")
          wait {
            ClearScreen
            msg ("\"Just some supplies that we'll be needing.\"")
            wait {
              ClearScreen
              msg ("\"Do you know where the key is? I'd like to start packing for our... expedition.\"")
              wait {
                ClearScreen
                msg ("\"Oh,\" Duffy says, thinking for a moment. \"I've got it right here, actually. Take what you can carry. And don't break anything.\"")
                AddToInventory (CrateKey)
                msg ("<br/><i>(You have recieved the key from Duffy. You will find it in your inventory)</i>")
              }
            }
          }
        ]]></item>
      </ask>
      <object name="CrateKey">
        <inherit name="editor_object" />
        <look>Key that unlocks the black crate in the Alien Medical Station.</look>
        <alias>Alien Crate Key</alias>
        <take />
        <alt type="stringlist">
          <value>supply crate</value>
          <value>key</value>
          <value>supply</value>
          <value>crate</value>
        </alt>
      </object>
      <object name="WhatAreYouDoingDuffy">
        <inherit name="editor_object" />
        <inherit name="startingtopic" />
        <displayverbs type="stringlist">
          <value>Look at</value>
          <value>Speak to</value>
        </displayverbs>
        <speak type="string"></speak>
        <alias>What are you doing, Duffy?</alias>
        <talk type="script">
          ClearScreen
          msg ("What are you up to, Duffy?")
          wait {
            ClearScreen
            msg ("\"Well, this is a medical drone,\" he says, shooting a lazer into some sort of optical device on the drone's surface. \"This lazer is streaming data into the memory core. Just a bunch of instructions that cover all inevitabilities. So now all I'm really doing is enhancing it with whatever time I have left. It will take over control of the medical station and keep things in peak shape while we are out and about.")
            wait {
              ClearScreen
              msg ("\"That's impressive technology,\" you say. \"Way ahead of what I remember us having.\"")
              Duffy2.Ask_What = True
            }
          }
        </talk>
      </object>
    </object>
    <object name="Alien Supply Crate">
      <inherit name="editor_object" />
      <inherit name="container_open" />
      <inherit name="container_lockable" />
      <isopen type="boolean">false</isopen>
      <nokeymessage><![CDATA[It's locked. Maybe Duffy or Ziggy have the key. <br/><br/><i>(Remember, not all possible conversations are/will be listed in the "Speak to" menu under each character.Some topics are hidden, and require you to use this example command, "Ask Duffy about key" to initiate).</i>]]></nokeymessage>
      <close type="boolean">false</close>
      <displayverbs type="stringlist">
        <value>Look at</value>
        <value>Unlock</value>
      </displayverbs>
      <unlockmessage type="string"></unlockmessage>
      <lockmessage type="string"></lockmessage>
      <openmsg>The crate top begins to shift, as locks slide out of place, and the top splits into two sections that mechanically twist and fold into two tiered-shelves; possibly for sorting and organizing the items inside.</openmsg>
      <closemsg>The crate's top shifts back into one slab, and the locks slide into place once more.</closemsg>
      <look>A very sturdy looking crate, constructed of a thick, black metal.</look>
      <visible type="boolean">false</visible>
      <autounlock type="boolean">false</autounlock>
      <key type="object">CrateKey</key>
      <onopen type="script"><![CDATA[
        UnlockExit (Outside of Medical Station)
        RemoveObject (CrateKey)
        msg ("<i>(Key removed from inventory)</i>")
      ]]></onopen>
      <object name="HackTool">
        <inherit name="editor_object" />
        <alias>Hacking tool</alias>
        <weight type="int">6</weight>
        <volume type="int">5</volume>
        <look><![CDATA[This tool will allow you to automatically solve a single puzzle or obstacle that focuses on mechanics. It can be used only once, after which it will be removed from your inventory. It takes up 5 volume in your inventory, which has a capacity of 12. Choose your tools wisely. <br/><br/><b>Note:</b> Some puzzles or obstacles have multiple tools that can be used to automatically solve them. For example: A puzzle involving a solar panels, to power a device, can use both the disruptor and hack tool to solve it, since the puzzle directly involves electrical energy and mechanical aspects. <br/><br/>However, a puzzle involving a crane would not accept a disrupter tool since electrical energy is not the focus of this puzzle.<br/><br/>**Tool does not have functionality in Demo, currently, and cannot be picked up. This is a preview of its intended functionality.**]]></look>
        <displayverbs type="stringlist">
          <value>Look at</value>
        </displayverbs>
      </object>
      <object name="Disruptor">
        <inherit name="editor_object" />
        <alias>Disruptor</alias>
        <weight type="int">6</weight>
        <volume type="int">4</volume>
        <look><![CDATA[This tool will allow you to automatically solve a single puzzle or obstacle that focuses on electricital energy of some kind. It can be used only once, after which it will be removed from your inventory. It takes up 4 volume in your inventory, which has a capacity of 12. Choose your tools wisely. <br/><br/><b>Note: </b>Some puzzles or obstacles have multiple tools that can be used to automatically solve them. For example: A puzzle involving a solar panels, to power a device, can use both the disruptor and hack tool to solve it, since the puzzle directly involves electrical energy and mechanical aspects. <br/><br/>However, a puzzle involving a crane would not accept a disrupter tool since electrical energy is not the focus of this puzzle.<br/><br/>**Tool does not have functionality in Demo, currently, and cannot be picked up. This is a preview of its intended functionality.**]]></look>
        <displayverbs type="stringlist">
          <value>Look at</value>
        </displayverbs>
      </object>
      <object name="Foresight">
        <inherit name="editor_object" />
        <alias>Foresight</alias>
        <weight type="int">3</weight>
        <volume type="int">3</volume>
        <look><![CDATA[Foresight is an experimental "Swift" tool that scans an area to find hidden objects or messages. It still has some "bugs" that need to be worked out. It only locates a single hidden object in any area, and requires several minutes to recharge after every use.<br/><br/>**Tool does not have functionality in Demo, currently, and cannot be picked up. This is a preview of its intended functionality.**]]></look>
        <displayverbs type="stringlist">
          <value>Look at</value>
        </displayverbs>
      </object>
      <object name="Cryocharge">
        <inherit name="editor_object" />
        <alias>Cryocharge</alias>
        <visible />
        <weight type="int">6</weight>
        <volume type="int">6</volume>
        <look><![CDATA[This tool will allow you to automatically solve a single puzzle or obstacle that focuses on an obstruction of some kind. It can be used only once, after which it will be removed from your inventory. It takes up 6 volume in your inventory, which has a capacity of 12. Choose your tools wisely. <br/><br/>**Tool does not have functionality in Demo, currently, and cannot be picked up. This is a preview of its intended functionality.**]]></look>
        <displayverbs type="stringlist">
          <value>Look at</value>
        </displayverbs>
      </object>
    </object>
    <exit name="Outside of Medical Station" alias="north" to="OutsideMedicalStation">
      <inherit name="northdirection" />
      <locked />
      <lockmessage>I should talk to Ziggy and Duffy, and stock up on supplies before I start looking for answers in the city.</lockmessage>
      <visible type="boolean">false</visible>
    </exit>
    <object name="laser">
      <inherit name="editor_object" />
      <displayverbs type="stringlist">
        <value>Look at</value>
        <value>Touch</value>
      </displayverbs>
      <touched type="boolean">false</touched>
      <look>A laser device, seemingly used for medical procedures. </look>
      <visible type="boolean">false</visible>
      <touch type="script"><![CDATA[
        if (laser.touched = True) {
          msg ("\"Is my device failing to translate this, or are you trying to test my patience. No more.\" Duffy shouts.")
          msg ("<br/>\"Now, now, Duffy,\" Ziggy says, wiggling her fingers in some form of alien body language. \"I'm sure a little recalibration is a small price to pay for being the first Swift to find a human.\"")
          MakeObjectInvisible (laser)
        }
        else if (laser.touched = False) {
          msg ("\"Don't touch that, human. It took me two hours to calibrate.\" Duffy says, raising his voice.\"If you mess it up, I'll calibrate you instead.\"")
          laser.touched = True
        }
      ]]></touch>
    </object>
    <object name="strange device">
      <inherit name="editor_object" />
      <look>A small device with elements of a circle and a triangle in its design. The center of the device is circular, but there are three triangular limbs that extend from the base. .</look>
      <take />
      <volume type="int">1</volume>
      <displayverbs type="stringlist">
        <value>Look at</value>
      </displayverbs>
      <visible type="boolean">false</visible>
      <touch type="script"><![CDATA[
        ClearScreen
        msg ("You touch this unusual device. In an instant, your surroundings appear to change. You feel as if you are being flung into a vast void at the speed of light. A cold auru rushes over and around your limp body. <br/><br/>Your body comes to a jarring hault in this abyss. You are surrounded by what appears to be constellations. They are the only beyond the incredibly distant pin-pricks of ancient stars in the black fabric of the horizon. <br/><br/>You wonder if the device you touched in the Medical Station has killed you, and that this is the beggining of some glorious ascension. But nothing further seems to be happening, except for the randomly pulsating lights eminating from the constellations that surround you. <br/><br/>You cannot move a muscle in your body, and the deep cold creeps further and further up your spine, like fingers inching their way up the vertebrae.<br/>")
        MakeObjectInvisible (strange device)
        MoveObject (player, ColdVoid)
      ]]></touch>
    </object>
  </object>
  <object name="OutsideMedicalStation">
    <inherit name="editor_room" />
    <alias>entrance to the Medical Station</alias>
    <description type="script"><![CDATA[
      ClearScreen
      firsttime {
        msg ("You exit the Medical Station and see the world for the first time in over a hundred years. <br/><br/>You wonder, for a moment, if the aliens are decieving you. Perhaps they took you to thier own world. Maybe this isn't Earth.<br/><br/>But you see the decaying remains of office buildings; vines cascade over each floor, and into the broken broken windows, like water pouring over the cells in a honeycomb.<br/><br/>A large tree sits in the middle of a nearby street, having pierced the hitch of a truck, splitting tractor from trailer.<br/><br/>The verdent landscape reminds you of deep-jungle plateaus, with ancient indian temples built into the mountain sides; starved out by new growth.<br/><br/>The dizzy sensation returns. but you quickly shake it and continue.")
      }
      otherwise {
        msg ("You are outside the Medical Station<br/><br/>A large tree sits in the middle of a nearby street, having pierced the hitch of a truck, splitting tractor from trailer.<br/><br/>The verdent landscape reminds you of deep-jungle plateaus, with ancient indian temples built into the mountain sides; starved out by new growth.")
      }
    ]]></description>
    <exit alias="south" to="MedicalStation">
      <inherit name="southdirection" />
      <lockmessage>I can't leave just yet. We will need to stock up on supplies before we leave.</lockmessage>
    </exit>
    <object name="Duffy3">
      <inherit name="editor_object" />
      <inherit name="namedmale" />
      <inherit name="talkingchar" />
      <alias>Duffy</alias>
      <displayverbs type="stringlist">
        <value>Talk to</value>
      </displayverbs>
      <object name="Duffy3PhoneConvo">
        <inherit name="editor_object" />
        <inherit name="topic" />
      </object>
    </object>
    <object name="Ziggy3">
      <inherit name="editor_object" />
      <inherit name="namedfemale" />
      <alias>Ziggy</alias>
      <displayverbs type="stringlist">
        <value>Talk to</value>
      </displayverbs>
      <object name="WhatRUThinking">
        <inherit name="editor_object" />
        <inherit name="startingtopic" />
        <visible />
        <talk type="script"><![CDATA[
          ClearScreen
          msg ("Ziggy is slowly panning her head from one side of the horizon to the next, She appears to be contemplating something about the ruins, <br/><br/>\"What are you thinking right now, Ziggy?\"")
          wait {
            ClearScreen
            msg ("\"A lot of things... but, mostly I'm sad,\" she replies. \"What I wouldn't give to be here before this happened. To see your people prosper. Instead, there's nothing but ghosts of the past, and empty husks. I know it can't compare to what you're feeling right now.\"")
            wait {
              msg ("\"No,\" you reply. \"That pretty much sums it up.\"")
              wait {
                ClearScreen
              }
            }
          }
        ]]></talk>
      </object>
    </object>
    <object name="BustedTimeCapsule">
      <inherit name="editor_object" />
      <inherit name="container_open" />
      <open type="boolean">false</open>
      <close type="boolean">false</close>
      <transparent />
      <hidechildren />
      <listchildren type="boolean">false</listchildren>
      <alias>busted time capsule</alias>
      <displayverbs type="stringlist">
        <value>Look at</value>
      </displayverbs>
      <look>This time capsule recently busted open. Possibly during the alien's excavation of my stasis chamber. There are a few items of interest scattered around it. I should take a look at them. Something might be useful.</look>
      <object name="VialWPaper">
        <inherit name="editor_object" />
        <look><![CDATA[The vial contains a roll of paper. The paper says, <br/><br/>Hello from Westfall Elementary class of 2024. We are excited to leave for you a few original drawings and writings from our students, and a small stash of our times precious technology. It is our hope that the creativity of our class will inspire whoever should find this, and that the technology will leave you in awe of the progress of mankind. The world you see before you now is thanks, in no small part, to the students of 2024. ]]></look>
        <alias>vial with piece of paper inside</alias>
        <takemsg>You take the vial.</takemsg>
        <take />
      </object>
      <object name="FolderWDrawings">
        <inherit name="editor_object" />
        <alias>folder containing dozens of drawings</alias>
        <takemsg>You pick up the folder of children's drawings. 'These are going right on the fridge,' you think to yourself.</takemsg>
        <look>This appears to be a folder full of drawings from the class of 2024. There is a picture of people holding hands under the sun; a picture of a yeti; a picture of a big city, "where daddy works"; Etc.</look>
        <take />
      </object>
      <object name="CellPhone">
        <inherit name="editor_object" />
        <alias>cell phone</alias>
        <take />
        <drop type="boolean">false</drop>
        <takemsg><![CDATA[<i>(Phone placed in inventory)</i>]]></takemsg>
        <use />
        <listalias>cell phone</listalias>
        <dropmsg>The phone is too important to drop. Luckily, it's functionally weightless.</dropmsg>
        <reprogrammed type="boolean">false</reprogrammed>
        <look type="script">
          if (CellPhone.reprogrammed = False) {
            msg ("This phone's battery is dead. Still, it might be useful. Thankfully, while some of the other stuff is broken, this was spared. I'd better show this to Duffy.")
          }
          else if (CellPhone.reprogrammed = True) {
            msg ("The cell phone was reprogrammed by Duffy. I need to hold onto this thing. He says it could be a valuable interface with any human technology that's survived.. ")
          }
        </look>
        <ontake type="script"><![CDATA[
          ClearScreen
          msg ("\"I found an old cell phone,\" you say, turning to the aliens. \"It looks like it could still work.\"")
          wait {
            ClearScreen
            msg ("\"Let me see that,\" Duffy replies. \"With a little reprogramming, this could be a valuable interface with any human technology we encounter.\"<br/><br/>Duffy presses a button on his wrist device, which begins scanning the phone. Suddenly, the phone bursts to life and begins its start-up sequence. He hands the device back to me.<br/><br/>\"Reprogramming...\" he pauses for a moment,\" successful. Hold on to it. We might need it.\"")
            CellPhone.reprogrammed = True
            UnlockExit (split paths)
            wait {
              do (OutsideMedicalStation, "description")
            }
          }
        ]]></ontake>
      </object>
      <object name="Watch">
        <inherit name="editor_object" />
        <alias>watch</alias>
        <takemsg>You pick up the broken watch. Maybe it can be fixed?</takemsg>
        <look>This watch is missing a band, and it won't turn on. Either the battery is dead, or it's broken.</look>
        <take />
      </object>
      <object name="MusicCDs">
        <inherit name="editor_object" />
        <alias>music CD's</alias>
        <take />
        <look>This pile of CD's appears to be oriented towards tweens and younger children. If you are remembering right, it's not at all your taste in music.</look>
        <takemsg>You take the CDs. Maybe you could play frisbee with them...?</takemsg>
      </object>
      <object name="MP3Player">
        <inherit name="editor_object" />
        <alias>MP3 Player</alias>
        <take />
        <look>You're pretty sure this is an MP3 player, but it matters little now. The screen is cracked and what looks like battery acid has leaked from the case.</look>
        <takemsg>You take the MP3 player. You doubt its usefulness, but what've you got to lose in keeping it?</takemsg>
        <dropmsg>You drop the MP3 player. The music was too... classical... for your taste.</dropmsg>
      </object>
      <object name="Book">
        <inherit name="editor_object" />
        <alias>Lord of the Flies</alias>
        <takemsg>You reach down to take it, but have second thoughts. 'This isn't on my approved reading list', you tell yourself.</takemsg>
        <look>A book titled, "Lord of the Flies". You vaguely remember this from your childhood. Possibly, it was this classes' favorite work.</look>
      </object>
    </object>
    <exit name="split paths" alias="north" to="ForkInTheRoad">
      <inherit name="northdirection" />
      <locked />
      <lockmessage>I should rummage through that time capsule before I proceed. There could be something particularly useful there.</lockmessage>
    </exit>
  </object>
  <object name="ForkInTheRoad">
    <inherit name="editor_room" />
    <alias>street leading to multiple locations within the city</alias>
    <descprefix>You are at</descprefix>
    <description><![CDATA[<br/><br/>You're at a crossroads. It looks as if there are multiple paths to choose from. If you make a decision, you will need to commit. There will be no turning back; although the paths may cross at some point. <br/><br/><br/><i>(Your choices are...)</i> <br/><br/><b><u>Streets:</u></b> a challenging-difficulty pathway. If you choose to proceed, you will not be able to return and choose another path. <br/><br/><b><u>Sewers:</u></b> a casual-difficulty pathway. If you choose to proceed, you will not be able to return and choose another path. <br/>Not available (This is a demo version; this path is not currently available. Only "Challenging Difficulty: Streets" is available at this time).<br/>]]></description>
    <object name="Ziggy4">
      <inherit name="editor_object" />
      <inherit name="namedfemale" />
      <inherit name="talkingchar" />
      <alias>Ziggy</alias>
      <displayverbs type="stringlist">
        <value>Speak to</value>
      </displayverbs>
      <object name="Zigg4YourChoiceConvo">
        <inherit name="editor_object" />
        <inherit name="startingtopic" />
        <alias>Which path?</alias>
        <talk type="script">
          ClearScreen
          msg ("\"Which way should we go?\" you ask.")
          wait {
            ClearScreen
            msg ("\"It's up to you. You lead, and we will follow,\" Ziggy replies.")
          }
        </talk>
      </object>
    </object>
    <object name="Duffy4">
      <inherit name="editor_object" />
      <inherit name="namedmale" />
      <inherit name="talkingchar" />
      <alias>Duffy</alias>
      <displayverbs type="stringlist">
        <value>Look at</value>
      </displayverbs>
      <look>Duffy stands nearby, waiting for you to decide which path to take.</look>
    </object>
    <exit name="city streets" alias="north" to="MediumPathStreets">
      <inherit name="northdirection" />
    </exit>
    <exit name="sewer system" alias="northwest" to="CasualPathSewers">
      <inherit name="northwestdirection" />
      <locked />
      <lockmessage>This path is not yet available, as this is currently a demo build.</lockmessage>
    </exit>
    <exit name="Medical Station" alias="south" to="MedicalStation">
      <inherit name="southdirection" />
      <locked type="boolean">false</locked>
    </exit>
  </object>
  <object name="MediumPathStreets">
    <inherit name="editor_room" />
    <alias>City Streets (Challenging Pathway)</alias>
    <description type="script"><![CDATA[
      if (MassiveSkeleton.complete = True) {
        msg ("The massive skeleton is complete, and now viable as a makeshift bridge. It is still a mystery as to why the bed of wires has power. Maybe. you suppose, the answers lie ahead.")
      }
      else {
        msg ("You proceed into the streets of a ruined city. The buildings warp and buckle under the crushing weight of time and deterioration. Rubble blocks sections of the street and building entrances. <br/><br/>Something in particular catches your eye. A massive skeleton of some unknown creature lies in the interesection ahead. It looks to be fragmented, with a few missing pieces. You wonder what the heck it could be, as it is much larger than any elephant - almost dinosaur in size. <br/><br/>It looks as if your path forward lies over or around this skeleton. But something is not right about the ground it lies on. You notices sparks. It is lying on a bed of live wires. Somehow, the wires are still electrified. That mystery, for the moment, is secondary to finding a way to cross. ")
      }
    ]]></description>
    <beforefirstenter type="script"><![CDATA[
      ClearScreen
      msg ("You catch a glimpse of something ahead, darting around a street corner. It disappears as quickly as you saw it. After a gurgling screech, its prescence quickly fades.<br/><br/>You associate its size with that of a bear; although you are sure it was not actually a bear.<br/><br/>Ziggy says to Duffy, \"You're prepared, right?\"<br/><br/>Duffy replies, \"That assumes I know what we're up against.\"")
      wait {
        ClearScreen
        MakeObjectVisible (DuffyMain)
        MakeObjectVisible (ZiggyMain)
        MakeObjectVisible (MassiveSkeleton)
        MakeObjectVisible (streetsign1)
        MakeObjectVisible (Bone05)
        MakeExitVisible (Courtyard)
        MakeExitVisible (tank on the curb)
        MakeExitVisible (makeshift refugee center)
      }
    ]]></beforefirstenter>
    <onexit type="script">
      ClearScreen
    </onexit>
    <object name="DuffyMain">
      <inherit name="editor_object" />
      <inherit name="namedmale" />
      <inherit name="talkingchar" />
      <alias>Duffy</alias>
      <visible type="boolean">false</visible>
      <ask type="scriptdictionary">
        <item key="marquee sign scrolling message digital"><![CDATA[
          msg ("<br/>\"A sign?\" Duffy asks. \"And you're sure it's digital? Try using the reprogrammed cell phone. Point and click, and it should handle the rest. If it works, the scan should display any information stored inside.\"")
        ]]></item>
      </ask>
      <object name="DuffyMainMarqueeConvo">
        <inherit name="editor_object" />
        <inherit name="topic" />
        <alias>I found a digital marquee</alias>
        <visible />
        <hideafter />
        <talk type="script"><![CDATA[
          msg ("<br/>\"I found a scolling digital marquee,\" you say.")
          if (Marquee.scanned = True) {
            msg ("<br/>Duffy replies, \"Your phone is signaling that you've already tried scanning it and got a message. Smart thinking. I might be starting to like you, human.\"")
            msg ("<br/>\"It mentions Marshall Law being declared in the United States,\" you add. \"Something toppled the government pretty quickly. It seems to have been a complete surprise, since there were no evacuations before the collapse.\"<br/><br/>Duffy shakes his head in acknowledgement.")
            do (DuffyMainMarqueeConvo, "hide")
          }
          else if (Marquee.scanned = False) {
            msg ("<br/>\"Interesting,\" Duffy says. \"I would try scanning it with your cell phone. Perhaps there's a computer chip inside that the device can extract information from.\"")
            do (DuffyMainMarqueeConvo, "hide")
          }
          if (TankEmblem.lookedat = True) {
            msg ("<br/>\"The marquee headline makes me want to say we're in the United States,\" you add, \"but that combat tank is Brtish. There's gotta be more to this than meets the eye.")
            do (DuffyMainMarqueeConvo, "hide")
            msg ("<br/>\"Hmmm. Interesting. Keep looking.\"")
          }
        ]]></talk>
      </object>
      <object name="DuffyMainWhatDidYouBring">
        <inherit name="editor_object" />
        <inherit name="startingtopic" />
        <alias>What supplies did your bring?</alias>
        <talk type="script"><![CDATA[
          msg ("\"What supplies did you bring with you?\" you ask.<br/><br/>\"Everything that I need. And nothing that I don't,\" Duffy answers, bluntly.")
        ]]></talk>
      </object>
      <object name="DuffyMainHowDoWeCrossTheSkeleton">
        <inherit name="editor_object" />
        <inherit name="startingtopic" />
        <alias>How do we cross the skeleton?</alias>
        <talk type="script"><![CDATA[
          msg ("<br/>\"How do we cross the skeleton?\"<br/><br/>\"By diving face first into the bed of live wires,\" Duffy replies.")
        ]]></talk>
      </object>
    </object>
    <object name="ZiggyMain">
      <inherit name="editor_object" />
      <inherit name="namedfemale" />
      <inherit name="talkingchar" />
      <alias>Ziggy</alias>
      <visible type="boolean">false</visible>
      <ask type="scriptdictionary">
        <item key="marquee sign digital message"><![CDATA[
          msg ("<br/>You found a digital sign? Interesting find! I'm afraid that i'm less technologically inclined than Duffy. You might try asking him if we can get anything out of it.")
        ]]></item>
      </ask>
      <object name="ZiggyWhatWasThat">
        <inherit name="editor_object" />
        <inherit name="startingtopic" />
        <alias>What was that creature we saw?</alias>
        <talk type="script"><![CDATA[
          ClearScreen
          msg ("\"What was that creature we saw?\" you ask.<br/><br/>Ziggy turns her head and frowns, replying, \"I was hoping you could tell me.\"<br/><br/>She slides her backpack off, reaching for something. It's a small disck the size of your thumb. She does something to it, which causes it to display a two-dimensional holographic screen with data readouts.<br/><br/>\"Something's wrong with my biometric scanner. Why does technology never work when you need it to?\"")
          wait {
            ClearScreen
            msg ("<br/>\"It's not showing anything?\" you ask.")
            msg ("<br/>\"No, it's showing something... that something is what bothers me.\"")
            wait {
              ClearScreen
              msg ("<br/>\"What do you mean?\"")
              msg ("<br/>\"The biomass around us is at critical levels,\" Ziggy continues. \"There are more organisms here than the evironment could ever possibly sustain.\"")
              wait {
                ClearScreen
                msg ("<br/>\"Ok, that sounds unusual - but what does it mean to us?\"")
                msg ("<br/>\"It means that my scanner is broken; or creatures are gathering and moving in on our location.\"")
                msg ("<br/>Duffy finally takes interest in the conversation. \"I told you this was a bad idea. We should be waiting for backup. There's no logic in endangering our lives simply because this human can't remember what he had for breakfast a hundred years ago.\"")
                msg ("<br/>\"That's just it,\" Ziggy says. \"logic has nothing to do with it. Logic is a crutch. It only gets you so far.\"<br/><br/>Duffy turns away, making a hissing noise.<br/><br/>Ziggy adds, \"Besides - what do you humans say - 'curiosity is the cat killer'? I have confidence that Duffy can handle anything that gets too curious.\"<br/><br/>\"Ironic,\" Duffy continues. \"Since curiosity is <b>your</b> crutch.\" He takes a few steps toward the skeleton, checking it over carefully.")
                wait {
                  ClearScreen
                }
              }
            }
          }
        ]]></talk>
      </object>
      <object name="ZiggyMainWhatDidYouBring">
        <inherit name="editor_object" />
        <inherit name="startingtopic" />
        <alias>What supplies did you bring with you?</alias>
        <talk type="script"><![CDATA[
          msg ("\"What supplies did you bring with you?\" you ask.<br/><br/>\"Well,\" Ziggy replies. \"I brought my scanners, some nasty dehyrdated food bars, excavation tools, and a data log.\"")
        ]]></talk>
      </object>
      <object name="ZiggyMainHowDoWeCrossTheSkeleton">
        <inherit name="editor_object" />
        <inherit name="startingtopic" />
        <alias>How do we cross the skeleton?</alias>
        <talk type="script"><![CDATA[
          msg ("<br/>\"How do we cross the skeleton?\"<br/><br/>\"It looks like we need to cross by climbing over the skeleton. Right now, it doesn't look sturdy enough. I think we need to reattach the missing bone fragments before we can continue.")
        ]]></talk>
      </object>
      <object name="ZiggyMainMilitaryComplexScans">
        <inherit name="editor_object" />
        <inherit name="topic" />
        <look type="string"></look>
        <alias>What are your scans picking up?</alias>
        <talk type="script"><![CDATA[
          msg ("<br/>\"Hmm\", Ziggy says. \"Scans are finding that the power source... you know - whatever was giving juice to that bed of wires... it's nearby. Exactly where - I don't know yet.")
        ]]></talk>
      </object>
    </object>
    <exit name="makeshift refugee center" alias="west" to="StreetIntro1A">
      <inherit name="westdirection" />
      <visible type="boolean">false</visible>
    </exit>
    <exit name="tank on the curb" alias="east" to="StreetIntro1B">
      <inherit name="eastdirection" />
      <visible type="boolean">false</visible>
    </exit>
    <exit name="Courtyard" alias="north" to="LetThereBeLight">
      <inherit name="northdirection" />
      <locked />
      <lockmessage>This way is blocked by a bed of live wires. I need to complete the skeleton to use it as a bridge over the deadly ground.</lockmessage>
      <visible type="boolean">false</visible>
      <script type="script">
        MoveObject (DuffyMain, LetThereBeLight)
        MoveObject (ZiggyMain, LetThereBeLight)
        MoveObject (player, LetThereBeLight)
      </script>
    </exit>
    <object name="Bone05">
      <inherit name="editor_object" />
      <alias>bone fragment</alias>
      <take />
      <drop type="boolean">false</drop>
      <dropmsg>I need this.</dropmsg>
      <look>It's a bone fragment from the skeleton. I will need this to complete the skeleton and proceed.</look>
      <takemsg>You have grabbed a fragment of the skeleton.</takemsg>
      <taken type="boolean">false</taken>
      <visible type="boolean">false</visible>
      <ontake type="script">
        Bone05.taken = True
      </ontake>
    </object>
    <object name="MassiveSkeleton">
      <inherit name="editor_object" />
      <alias>massive skeleton</alias>
      <look><![CDATA[This creature is huge. Nothing that you remember can compare. Its jaw bones are shattered, but you make out a myriad of sharp teeth, about the size of two fingers, scattered around it.<br/><br/>You need this skeleton to be complete for it to be stable enough to climb on it, and to cross the bed of live wires. The bone fragments shouldn't have strayed too far from here. <br/><br/><i>(Collect bone fragments. Five total.)</i>]]></look>
      <displayverbs type="stringlist">
        <value>Look at</value>
      </displayverbs>
      <complete type="boolean">false</complete>
      <visible type="boolean">false</visible>
      <completeskeleton type="script"><![CDATA[
        if (Bone01.taken = True) {
          if (Bone02.taken = True) {
            if (Bone03.taken = True) {
              if (Bone04.taken = True) {
                if (Bone05.taken = True) {
                  msg ("That's it! You have the bone fragments.<br/><br/>Duffy walks over and begins attaching powerful magnets with some tool that reminds you of a gun. The magnets fire out of the device at a high speed, sticking firmly to the bones.<br/><br/>Using the device to manipulate the magnets, Duffy begins hoisting the bone fragments, and floating them into their correct positions on the skeleton. With the skeleton complete, and additional magnets fired into place, the skeleton has become stable and sturdy enough to cross, by climbing on top of it.")
                  msg ("<br/><i>(Your path over the skeleton is clear.)</i>")
                  UnlockExit (Courtyard)
                  RemoveObject (Bone01)
                  RemoveObject (Bone02)
                  RemoveObject (Bone03)
                  RemoveObject (Bone04)
                  RemoveObject (Bone05)
                  do (DuffyMainHowDoWeCrossTheSkeleton, "hide")
                  do (ZiggyMainHowDoWeCrossTheSkeleton, "hide")
                  MassiveSkeleton.complete = True
                }
                else {
                  msg ("You don't have all of the bone fragments needed to complete the skeleton. You need all five to assemble it in a way that allows you to cross the bed of live electrical wires.")
                }
              }
              else {
                msg ("You don't have all of the bone fragments needed to complete the skeleton. You need all five to assemble it in a way that allows you to cross the bed of live electrical wires.")
              }
            }
            else {
              msg ("You don't have all of the bone fragments needed to complete the skeleton. You need all five to assemble it in a way that allows you to cross the bed of live electrical wires.")
            }
          }
          else {
            msg ("You don't have all of the bone fragments needed to complete the skeleton. You need all five to assemble it in a way that allows you to cross the bed of live electrical wires.")
          }
        }
        else if (Bone01.taken = False) {
          msg ("You don't have all of the bone fragments needed to complete the skeleton. You need all five to assemble it in a way that allows you to cross the bed of live electrical wires.")
        }
        else if (Bone02.taken = False) {
          msg ("You don't have all of the bone fragments needed to complete the skeleton. You need all five to assemble it in a way that allows you to cross the bed of live electrical wires.")
        }
        else if (Bone03.taken = False) {
          msg ("You don't have all of the bone fragments needed to complete the skeleton. You need all five to assemble it in a way that allows you to cross the bed of live electrical wires.")
        }
        else if (Bone04.taken = False) {
          msg ("You don't have all of the bone fragments needed to complete the skeleton. You need all five to assemble it in a way that allows you to cross the bed of live electrical wires.")
        }
        else if (Bone05.taken = False) {
          msg ("You don't have all of the bone fragments needed to complete the skeleton. You need all five to assemble it in a way that allows you to cross the bed of live electrical wires.")
        }
      ]]></completeskeleton>
    </object>
    <object name="streetsign1">
      <inherit name="editor_object" />
      <alias>street sign</alias>
      <look>A street sign with some graffiti on it. It says, "7th street".</look>
      <visible type="boolean">false</visible>
    </object>
  </object>
  <object name="CasualPathSewers">
    <inherit name="editor_room" />
    <alias>City Sewer System (Casual Pathway)</alias>
    <exit alias="southeast" to="ForkInTheRoad">
      <inherit name="southeastdirection" />
    </exit>
  </object>
  <object name="StreetIntro1A">
    <inherit name="editor_room" />
    <alias>refugee center</alias>
    <description><![CDATA[<br/>This area is a mess. Debris litters the floor, and a carpet of vines has overgrown the fractured tiles. What looks like rows of decayed seating, like a triage waiting room, snakes around the room. ]]></description>
    <object name="LoveNote">
      <inherit name="editor_object" />
      <alias>lover's message on the wall</alias>
      <displayverbs type="stringlist">
        <value>Look at</value>
      </displayverbs>
      <look><![CDATA[A very faded message is painted on the wall. It says, <br/><br/>Jen Barrister (drawn heart) Desmond. I have to get the children to safety. Find us. You know how to follow the bread crumbs. Remember, I love you!]]></look>
    </object>
    <exit alias="east" to="MediumPathStreets">
      <inherit name="eastdirection" />
    </exit>
    <object name="Marquee">
      <inherit name="editor_object" />
      <alias>scrolling marquee</alias>
      <scanned type="boolean">false</scanned>
      <displayverbs type="stringlist">
        <value>Look at</value>
      </displayverbs>
      <look type="script"><![CDATA[
        if (Marquee.scanned = False) {
          msg ("It's an old scrolling digital marquee. You notice that there are incredibly faint words burned into the device, possibly because it froze on those words for some time. You can barely make it out, <br/><br/>\"Breaking News: Chaos as...\" <br/><br/>but the rest is cut-off.")
          do (DuffyMainMarqueeConvo, "show")
        }
        else if (Marquee.scanned = True) {
          msg ("It's the scrolling digital marquee that I scanned. The reprogrammed phone revealed that it was displaying a message before it broke.<br/><br/>It said, Breaking News: Chaos as the government of the United States has officially dissolved into a state of martial law. All remaining citizens are advised to flee high-density population areas.")
        }
      ]]></look>
      <useon type="scriptdictionary">
        <item key="CellPhone"><![CDATA[
          ClearScreen
          msg ("You hover the reprogrammed cell phone over this marquee, and initiate a scan. After several moments, data is displayed on it's screen. <br/><br/>It says, Breaking News: Chaos as the government of our United States has officially dissolves into a state of martial law. All remaining citizens are advised to flee high density population areas.")
          Marquee.scanned = True
          do (DuffyMainMarqueeConvo, "show")
        ]]></item>
      </useon>
    </object>
    <object name="Bone03">
      <inherit name="editor_object" />
      <alias>bone fragment</alias>
      <look>It's a bone fragment from the skeleton. I will need this to complete the skeleton and proceed.</look>
      <take />
      <drop type="boolean">false</drop>
      <dropmsg>I need this.</dropmsg>
      <takemsg>You've grabbed a fragment of the skeleton.</takemsg>
      <taken type="boolean">false</taken>
      <ontake type="script">
        Bone03.taken = True
      </ontake>
    </object>
    <object name="Bone04">
      <inherit name="editor_object" />
      <alias>bone fragment</alias>
      <visible />
      <take />
      <drop type="boolean">false</drop>
      <dropmsg>I need this.</dropmsg>
      <scenery />
      <look>It's a bone fragment from the skeleton. I will need this to complete the skeleton and proceed.</look>
      <takemsg>You've grabbed a fragment of the skeleton.</takemsg>
      <taken type="boolean">false</taken>
      <ontake type="script">
        Bone04.taken = True
      </ontake>
    </object>
    <object name="DebrisSlab">
      <inherit name="editor_object" />
      <alias>aluminum slab</alias>
      <displayverbs type="stringlist">
        <value>Look at</value>
      </displayverbs>
      <drop />
      <lookedat type="boolean">false</lookedat>
      <moved type="boolean">false</moved>
      <look type="script"><![CDATA[
        msg ("This slab of aluminum debris is sitting in front of an old telelphone booth. It doesn't look very heavy. <br/><br/>If you lean to the side, you can catch a glimpse of something , long, slender, and ivory in color lying behind it.")
        DebrisSlab.lookedat = True
      ]]></look>
    </object>
  </object>
  <object name="StreetIntro1B">
    <inherit name="editor_room" />
    <alias>tank sitting on the curb</alias>
    <descprefix>You are by</descprefix>
    <description type="script"><![CDATA[
      msg ("It's some derelict combat tank. The main cannon's barrel is bent downward. something must have fallen on it, to be warped like that, but there is no debris around the vehicle.<br/><br/>You don't recognize the type, but there's probably a mark or flag, for the country of origin. That might help you narrow down where you are. Who knows what things you might remember after you can nail down your location?")
    ]]></description>
    <object name="CombatTank">
      <inherit name="editor_object" />
      <inherit name="container_open" />
      <alias>tank</alias>
      <close type="boolean">false</close>
      <look>This is an old combat tank. Rust spreads from around seams and where bolts connect to the armor plating. The tank's hatch is closed, but unlocked. Maybe items inside have survived in fair shape all this time. </look>
      <contentsprefix>crew compartment contains</contentsprefix>
      <hidechildren type="boolean">false</hidechildren>
      <displayverbs type="stringlist">
        <value>Look at</value>
      </displayverbs>
      <inventoryverbs type="stringlist">
        <value>Look at</value>
      </inventoryverbs>
      <isopen type="boolean">false</isopen>
      <listchildren />
      <alt type="stringlist">
        <value>hatch</value>
      </alt>
      <openmsg>You open the tank's hatch.</openmsg>
      <searchfortankemblem type="script"><![CDATA[
        if (TankEmblem.clean =  False) {
          ClearScreen
          msg ("The tank's national flag has been covered in years of dirt and grime. I can't see the image clearly at all. I could wipe some of the mess off.")
          wait {
            if (Ask("Wipe grime off of flag emblem?")) {
              msg ("<br/>You recognize that flag. Britain. This is a British tank!")
              TankEmblem.clean = True
              TankEmblem.lookedat = True
            }
            else {
              msg ("<br/>You choose not to wipe the grime off of the tank emblem.")
            }
          }
        }
        else if (TankEmblem.clean = True) {
          msg ("<br/>I previously cleaned this tank emblem off. It shows the British flag.")
        }
      ]]></searchfortankemblem>
      <onopen type="script"><![CDATA[
        msg ("<br/>After all these years, the vehicle has acted like a pressure cooker, destroying most of the items inside. But you see various objects inside the tank's crew compartment that might be useful.")
      ]]></onopen>
      <object name="Bone01">
        <inherit name="editor_object" />
        <alias>bone fragment</alias>
        <take />
        <drop type="boolean">false</drop>
        <dropmsg>I need this.</dropmsg>
        <look>It's a bone fragment from the skeleton. I will need this to complete the skeleton and proceed.</look>
        <scenery type="boolean">false</scenery>
        <visible />
        <takemsg>You've grabbed a fragment of the skeleton.</takemsg>
        <taken type="boolean">false</taken>
        <ontake type="script">
          Bone01.taken = True
        </ontake>
        <inventoryverbs type="stringlist">
          <value>Look at</value>
          <value>Drop</value>
        </inventoryverbs>
      </object>
      <object name="Metalpole">
        <inherit name="editor_object" />
        <alias>strong metal pole</alias>
        <take />
        <volume type="int">0</volume>
        <takemsg>You pick up the metal pole.</takemsg>
        <visible />
        <look>A sturdy metal pole.</look>
        <use />
      </object>
      <object name="dogtags">
        <inherit name="editor_object" />
        <look><![CDATA[It's a pair of dog tags, from some long-dead soldier. It says, <br/><br/>"Ripley, <br/>John F. <br/>270-024-5830 <br/>O+ <br/>Catholic"]]></look>
        <alias>dog tags</alias>
        <displayverbs type="stringlist">
          <value>Look at</value>
          <value>Take</value>
        </displayverbs>
        <take />
        <takemsg>You take the dog tags.</takemsg>
        <visible />
        <inventoryverbs type="stringlist">
          <value>Look at</value>
          <value>Drop</value>
        </inventoryverbs>
      </object>
      <object name="teacup">
        <inherit name="editor_object" />
        <alias>tea cups</alias>
        <look>Pieces of tea cups are scattered about.</look>
        <displayverbs type="stringlist">
          <value>Look at</value>
        </displayverbs>
        <visible />
        <takemsg>You can't carry the fragments.</takemsg>
      </object>
      <object name="GrenadePin">
        <inherit name="editor_object" />
        <alias>grenade pin</alias>
        <take />
        <takemsg>You take the grenade pin. </takemsg>
        <look type="script">
          msg ("It's a grenade pin")
        </look>
        <inventoryverbs type="stringlist">
          <value>Look at</value>
          <value>Drop</value>
        </inventoryverbs>
      </object>
    </object>
    <exit alias="west" to="MediumPathStreets">
      <inherit name="westdirection" />
    </exit>
    <object name="TankEmblem">
      <inherit name="editor_object" />
      <alias>tank emblem</alias>
      <clean type="boolean">false</clean>
      <visible />
      <scenery />
      <alt type="stringlist">
        <value>flag</value>
        <value>emblem</value>
        <value>faction</value>
        <value>marker</value>
        <value>nation</value>
        <value>allegiance</value>
        <value>origin</value>
        <value>country</value>
      </alt>
      <listalias type="string"></listalias>
      <displayverbs type="stringlist">
        <value></value>
      </displayverbs>
      <lookedat type="boolean">false</lookedat>
      <drop type="boolean">false</drop>
      <ask type="scriptdictionary" />
    </object>
    <object name="Bone02">
      <inherit name="editor_object" />
      <alias>bone fragment</alias>
      <visible />
      <look>It's a bone fragment from the skeleton. I will need this to complete the skeleton and proceed.A</look>
      <take />
      <takemsg>You've grabbed a fragment of the skeleton.</takemsg>
      <taken type="string"></taken>
      <ontake type="script">
        Bone02.taken = True
      </ontake>
    </object>
  </object>
  <object name="LetThereBeLight">
    <inherit name="editor_room" />
    <alias>Courtyard</alias>
    <description><![CDATA[<br/>You've crossed the skeleton and are in a smalll courtyard. <br/><br/>To your left is a thrift store. Years of sunlight and weather have bleached the letters and worn them down to near-nothing, requiring you to afford more than a glance to read them. It says, "esmond's Pawn Shop". The first letter is missing. Probably a "D". <br/><br/>Straight ahead against a building wall, are solar panels and a generator, sitting under a short metal roof. <br/><br/>The only way to continue appears to be via a large iron bulkhead door in the building to the right. The building appears to be some sort of makeshift military complex.]]></description>
    <object name="solarpanels">
      <inherit name="editor_object" />
      <movepanelsintosun>I can't do that. They are firmly bolted into the cement.</movepanelsintosun>
      <cleaned type="boolean">false</cleaned>
      <smashed type="boolean">false</smashed>
      <alias>solar panels</alias>
      <displayverbs type="stringlist">
        <value>Look at</value>
      </displayverbs>
      <look type="script">
        if (solarpanels.cleaned = False) {
          msg ("It's an array of solar panels bolted into the cement ground. The panels are covered in dirt and grime. Wires snake from the panels to a nearby generator.")
        }
        else if (solarpanels.cleaned = True) {
          msg ("The solar panels are moderately clean now that I wiped them off. But they still aren't going anywhere since they are bolted to the ground. And trying to use brute force would never work; they are too fragile.")
        }
      </look>
      <cleanpanels type="script">
        msg ("You wipe the panels off in a delicate, but determined manner. It's not back to factory-new conditions, but its better than nothing. The question is how do you get light to reach them, with the metal roof casting a shadow.")
        solarpanels.cleaned = True
      </cleanpanels>
      <useon type="scriptdictionary">
        <item key="CellPhone"><![CDATA[
          msg ("<br/>You attempt to scan the solar panel with your cell phone. <br/><br/>The reprogrammed device alerts you that there are no computer chips of any kind to interface with in the solar panel array.")
        ]]></item>
        <item key="MysteriousOrb"><![CDATA[
          msg ("<br/>You pull out the mysterious orb and move it closer to the solar panels; finally touching one.<br/><br/>The mysterious orb continues being mysterious, as it has no reaction to the solar panel; and vice versa.")
        ]]></item>
        <item key="Metalpole"><![CDATA[
          if (solarpanels.smashed = False) {
            msg ("You bring your metal pole to bear, and strike a solar panel with a thwack.<br/><br/>The panel shatters, but the bolts in the base keep the structure upright.<br/><br/>You ask yourself, \"Why'd I do that?\" and you reply to yourself, \"for funsies.\"<br/><br/>Although, you resolve to not do it again, as having some intact solar panels is vital to powering that generator.")
            solarpanels.smashed = True
          }
          else if (solarpanels.smashed = True) {
            msg ("You promised yourself that you wouldn't go Gallagher on any more solar panels. They are the only thing that can power that generator; which will allow you to open the large iron door.")
          }
        ]]></item>
        <item key="mirror"><![CDATA[
          msg ("You turn the mirror so that the sun reflects off of it, directing the rays onto a solar panel.")
          if (solarpanels.cleaned = True) {
            msg ("<br/>A light on the generator begins blinking yellow, before turning to a solid green. The generator seems to be powering up correctly. <br/><br/>However, the iron door is not reacting to the generator as it powers up.<br/><br/>Ziggy offers to hold the mirror in place, while you inspect the generator and iron door.")
            generator.charged = True
          }
          else {
            msg ("<br/>A light on the nearby generator blinks red. Something is happening, but not enough light is being absorbed by the solar panels.")
          }
          // Type comment
        ]]></item>
      </useon>
    </object>
    <object name="metalroofing">
      <inherit name="editor_object" />
      <alias>metal roofing</alias>
      <displayverbs type="stringlist">
        <value>Look at</value>
      </displayverbs>
      <look type="script">
        msg ("It's a thin, metal roof worn down by the elements. Despite that, it seems to be in one piece, save for one tiny hole - and a beam of light shining through it.")
      </look>
    </object>
    <object name="IronDoor">
      <inherit name="editor_object" />
      <inherit name="container_open" />
      <hidechildren />
      <close type="boolean">false</close>
      <open type="boolean">false</open>
      <isopen type="boolean">false</isopen>
      <charged type="boolean">false</charged>
      <alias>iron bulkhead door</alias>
      <powered type="boolean">false</powered>
      <displayverbs type="stringlist">
        <value>Look at</value>
      </displayverbs>
      <look type="script">
        if (IronDoor.powered = True) {
          msg ("The generator and metal pole are doing their jobs. The door and keypad now have power. You will need to use the keypad to open the door at this point.")
        }
        else if (IronDoor.powered = False) {
          msg ("It's a thick, iron bulkhead door. There is a keypad, but the door won't be going anywhere without power. Unfortunately, whatever electricity was surging through the wires around that skeleton is not reaching the door. You'll have to find another way to power it. There's also an engraved note filed into the door.")
          MakeObjectVisible (keypad)
          MakeObjectVisible (engravednote)
        }
        else {
        }
      </look>
      <opendoor type="script">
        msg ("The door is too heavy and thick to open manually. It needs to be opened via the keypad, once power has been restored.")
      </opendoor>
    </object>
    <exit alias="south" to="MediumPathStreets">
      <inherit name="southdirection" />
    </exit>
    <object name="streetsign2">
      <inherit name="editor_object" />
      <look>This old street sign teeters precariously by a single bolt. Its pole has begun to lean. The sign reads, "8th street".</look>
      <alias>street sign</alias>
      <displayverbs type="stringlist">
        <value>Look at</value>
      </displayverbs>
    </object>
    <object name="generator">
      <inherit name="editor_object" />
      <displayverbs type="stringlist">
        <value>Look at</value>
      </displayverbs>
      <charged type="boolean">false</charged>
      <look type="script"><![CDATA[
        if (generator.charged = True) {
          msg ("The generator is powered, but the electricty isn't making it to the door. <br/><br/>After a few moments of inspecting the connections, you see a severed wire bundle.")
          MakeObjectVisible (disconnectedwires)
          MakeObjectVisible (engravednote)
          MakeObjectVisible (keypad)
        }
        else if (generator.charged = False) {
          msg ("This old solar generator looks like it might have a chance of working one more time. It just needs energy to convert into electricity.")
        }
      ]]></look>
    </object>
    <object name="disconnectedwires">
      <inherit name="editor_object" />
      <look>A wire is severed between the generator and the iron doors. The wire is too short to touch both severed ends. There needs to be some connection made between the two severed ends. Something that can complete the circuit for energy to pass into the door and activate it.</look>
      <visible type="boolean">false</visible>
      <scenery type="boolean">false</scenery>
      <alias>bundle of severed wires</alias>
      <displayverbs type="stringlist">
        <value>Look at</value>
      </displayverbs>
      <poleused type="boolean">false</poleused>
      <useon type="scriptdictionary">
        <item key="Metalpole">
          msg ("You drop the metal pole on the ground; then you careful grab both ends of severed wire and touch the metal pole. Electricity surges through the new connection, and the door's keypad lock powers up.")
          IronDoor.powered = True
          RemoveObject (Metalpole)
        </item>
      </useon>
    </object>
    <exit name="military complex" alias="east" to="MilitaryComplexLobby">
      <inherit name="eastdirection" />
      <locked />
      <lockmessage>This way is locked by the large iron door.</lockmessage>
      <visible />
    </exit>
    <exit alias="west" to="pawnshop">
      <inherit name="westdirection" />
    </exit>
    <object name="engravednote">
      <inherit name="editor_object" />
      <look><![CDATA[An engraved note on the iron door reads, <br/><br/>"I had to secure this door. It's not enough to simply close it. They're too smart. And we won't be around to open it for you, if you make it this far. We're heading five clicks north to the laboratory. I left a hint for the keypad combo. You know where to find it. <br/><br/>-JFR"]]></look>
      <alias>engraved note (iron door)</alias>
      <visible />
      <displayverbs type="stringlist">
        <value>Look at</value>
      </displayverbs>
    </object>
    <object name="keypad">
      <inherit name="editor_object" />
      <alias>keypad (iron door)</alias>
      <visible />
      <displayverbs type="stringlist">
        <value>Look at</value>
      </displayverbs>
      <look type="script">
        if (IronDoor.powered = False) {
          msg ("This keypad would require some code to open the iron door. But the keypad and door both lack power to operate. First, you will need to restore power.")
        }
        else if (IronDoor.powered = True) {
          msg ("The keypad is working. I could try to enter a code now.")
        }
      </look>
      <entercode type="script"><![CDATA[
        if (IronDoor.powered = False) {
          msg ("<br/>I can't enter a key code until I power up the door and this keypad.")
        }
        else if (IronDoor.powered = True) {
          msg ("<br/>The keypad needs a ten-digit code. <br/><br/><i>(Enter the code now; integers only)</i>")
          get input {
            if (result = "2700245830") {
              msg ("<br/>The door shifts and releases a loud thud. Gears struggle to lift the massive dead-weight, slab of iron. It slowly slides up, relinquishing control of entry into the military complex.")
              UnlockExit (military complex)
            }
            else {
              msg ("<br/>The keypad flashes red, and you hear a faint buzzing beep from the speakers below the keypad. Probably some sort of alarm that would go off for a wrong key code entry. Doesn't really work anymore.")
            }
          }
        }
      ]]></entercode>
      <useon type="scriptdictionary">
        <item key="cell phone">
        </item>
      </useon>
    </object>
  </object>
  <verb>
    <property>searchfor</property>
    <pattern>search for</pattern>
    <defaultexpression>"You can't search for " + object.article + "."</defaultexpression>
  </verb>
  <verb>
    <property>searchfortankemblem</property>
    <pattern>search for tank emblem</pattern>
    <defaultexpression>"You can't search for tank emblem " + object.article + "."</defaultexpression>
  </verb>
  <object name="ColdVoid">
    <inherit name="editor_object" />
    <alias>Cold Void</alias>
    <look><![CDATA[<br/><br/>Your body comes to a jarring hault in this abyss. You are surrounded by what appears to be constellations. They are the only thing beyond the incredibly distant pin-pricks of ancient stars in the black fabric of the horizon. <br/><br/>You wonder if the device you touched in the Medical Station has killed you, and that this is the beggining of some glorious ascension. But nothing further seems to be happening, except for the randomly pulsating lights eminating from the constellations that surround you. <br/><br/>You can't move a muscle in your body, and the deep cold creeps further and further up your spine, like fingers inching their way up the vertebrae.]]></look>
    <object name="flashing lights">
      <inherit name="editor_object" />
      <inherit name="container_open" />
      <displayverbs type="stringlist">
        <value>Look at</value>
      </displayverbs>
      <open type="boolean">false</open>
      <close type="boolean">false</close>
      <hidechildren />
      <look type="script"><![CDATA[
        msg ("<br/><br/>After closer inspection, you realize that these constellations are painting a picture with the flashing stars. They are displaying detailed animals. Although, the creatures do not appear to be from Earth. <br/><br/>Your mind tries to process the varying images, and you subconsciously group one of the constellations with another that appears to be of a similar organism. You realize that constellations move simply because you will them to. <br/><br/>It appears that there is a solution to this series of constellations. It seems like there is a special order required. But the requirements of that order seem vague. <br/><br/>In your attempt to decipher the problem, you notice something critical in common among all of the constellations. The creatures depicted in them progressively change from one constellation to another. The puzzle seems to want you place the animals in order of their evolution. It wants to know which animal you think came first, and which evolved last in this lineage.<br/><br/>Somehow, you seem to know the constellation's names. It seems likely the device you touched is offering certain information to help you solve its challenge. <br/><br/>You hear words in the farthest reaches of your mind tell you that life on this creature's planet, like on Earth, began in the oceans. This lineage of creatures developed around the time that the vast majority of biodiversity was still in the oceans, as opposed to the land-masses. <br/><br/>You also notice a  circle of glowing energy is forming beyond the constellations; possibly, it is a portal of some kind.")
        MakeObjectVisible (Portal)
      ]]></look>
      <object name="Constellation01">
        <inherit name="editor_object" />
        <alias>Constellation Muru Nakat</alias>
        <look><![CDATA[<br/><br/>This constellation marks a creature with four fairly short appendages that end in feet with webbing between the toes. The creature appears to have sharp, but short, nails at the end of each toe. The limbs are not quite long enough to allow the creature to lift its body off of the ground. It would rest on its belly, and could lift itself up when running or walking.<br/><br/>The appearance of these appendages remind you of a crocodile.<br/><br/>A tail extends that is medium-length and thick with musculature. <br/><br/>Its teeth are spaced in an uneven manner, but are long and thick]]></look>
        <displayverbs type="stringlist">
          <value>Look at</value>
        </displayverbs>
        <order type="int">1</order>
        <correctvalue type="int">4</correctvalue>
        <move type="script"><![CDATA[
          topics = Split("Move to first spot;Move to second spot;Move to third spot;Move to fourth spot;Move to fifth spot;Move to sixth spot;Move to seventh spot;Move to eighth spot",";")
          msg ("<br/>The creatures described by each constellation must be placed in order of which is the most ancient ( spot 1 out of 8), to which evolved latest, (spot 8 out of 8). You can give each constellation the same order value, but in finding the correct order, each constellation will need to have a different order value between 1 and 8.<br/>")
          msg ("This constellation is currently sitting in position " + Constellation01.order + " out of 8.")
          msg ("<br/>")
          show menu ("\"Which spot do you wish to place this constellation in?\"", topics, false) {
            switch (result) {
              case ("Move to first spot") {
                Constellation01.order = 1
              }
              case ("Move to second spot") {
                Constellation01.order = 2
              }
              case ("Move to third spot") {
                Constellation01.order = 3
              }
              case ("Move to fourth spot") {
                Constellation01.order = 4
              }
              case ("Move to fifth spot") {
                Constellation01.order = 5
              }
              case ("Move to sixth spot") {
                Constellation01.order = 6
              }
              case ("Move to seventh spot") {
                Constellation01.order = 7
              }
              case ("Move to eighth spot") {
                Constellation01.order = 8
              }
            }
            msg ("This constellation is now sitting in position " + Constellation01.order + " out of 8.")
          }
        ]]></move>
      </object>
      <object name="Constellation02">
        <inherit name="editor_object" />
        <alias>Constellation Goyo Vignat</alias>
        <look><![CDATA[<br/>This constellation marks a creature with two very long hind legs, and two short front appendages. The nails on the feet are long and curved upwards. The claws on the front appendages are vestigial, with digits that seem to be used for grabbing things, without large nails getting in the way. The creature appears to walk on its hind legs most, or all of the time. <br/><br/>A tail extends that is long and thin, but is quite muscular and obviously capable of being used as a whip, or for grabbing and holding onto things. <br/><br/>The creature's rear teeth are virtually flat, while its front teeth are wedge-shaped, and a few fangs lie at the tip of its snout.]]></look>
        <displayverbs type="stringlist">
          <value>Look at</value>
        </displayverbs>
        <order type="int">2</order>
        <correctvalue type="int">8</correctvalue>
        <move type="script"><![CDATA[
          topics = Split("Move to first spot;Move to second spot;Move to third spot;Move to fourth spot;Move to fifth spot;Move to sixth spot;Move to seventh spot;Move to eighth spot",";")
          msg ("<br/>The creatures described by each constellation must be place in order of which is the most ancient ( spot 1 out of 8), to which evolved latest, (spot 8 out of 8). You can give each constellation the same order value, but in finding the correct order, each constellation will need to have a different order value between 1 and 8.<br/>")
          msg ("This constellation is currently sitting in position " + Constellation02.order + " out of 8.")
          msg ("<br/>")
          show menu ("\"Which spot do you wish to place this constellation in?\"", topics, false) {
            switch (result) {
              case ("Move to first spot") {
                Constellation02.order = 1
              }
              case ("Move to second spot") {
                Constellation02.order = 2
              }
              case ("Move to third spot") {
                Constellation02.order = 3
              }
              case ("Move to fourth spot") {
                Constellation02.order = 4
              }
              case ("Move to fifth spot") {
                Constellation02.order = 5
              }
              case ("Move to sixth spot") {
                Constellation02.order = 6
              }
              case ("Move to seventh spot") {
                Constellation02.order = 7
              }
              case ("Move to eighth spot") {
                Constellation02.order = 8
              }
            }
            msg ("This constellation is now sitting in position " + Constellation02.order + " out of 8.")
          }
        ]]></move>
      </object>
      <object name="Constellation03">
        <inherit name="editor_object" />
        <alias>Constellation Bios Magnis</alias>
        <look><![CDATA[<br/><br/>This constellation marks a creature with four stubby appendages that support short flippers with ridges in them. The ridges seem to coincide with the number of digits that the other creatures in the constellation have. <br/><br/>The appearance of these appendages reminds you of a marine turtle.<br/><br/>A tail extends that is long and rounded, but has one extensive fin on the top, and one on the bottom. <br/><br/>Its teeth appear to be quite sharp, but thin and numerous.]]></look>
        <displayverbs type="stringlist">
          <value>Look at</value>
        </displayverbs>
        <order type="int">3</order>
        <correctvalue type="int">2</correctvalue>
        <move type="script"><![CDATA[
          topics = Split("Move to first spot;Move to second spot;Move to third spot;Move to fourth spot;Move to fifth spot;Move to sixth spot;Move to seventh spot;Move to eighth spot",";")
          msg ("<br/>The creatures described by each constellation must be place in order of which is the most ancient ( spot 1 out of 8), to which evolved latest, (spot 8 out of 8). You can give each constellation the same order value, but in finding the correct order, each constellation will need to have a different order value between 1 and 8.<br/>")
          msg ("This constellation is currently sitting in position " + Constellation03.order + " out of 8.")
          msg ("<br/>")
          show menu ("\"Which spot do you wish to place this constellation in?\"", topics, false) {
            switch (result) {
              case ("Move to first spot") {
                Constellation03.order = 1
              }
              case ("Move to second spot") {
                Constellation03.order = 2
              }
              case ("Move to third spot") {
                Constellation03.order = 3
              }
              case ("Move to fourth spot") {
                Constellation03.order = 4
              }
              case ("Move to fifth spot") {
                Constellation03.order = 5
              }
              case ("Move to sixth spot") {
                Constellation03.order = 6
              }
              case ("Move to seventh spot") {
                Constellation03.order = 7
              }
              case ("Move to eighth spot") {
                Constellation03.order = 8
              }
            }
            msg ("This constellation is now sitting in position " + Constellation03.order + " out of 8.")
          }
        ]]></move>
      </object>
      <object name="Constellation04">
        <inherit name="editor_object" />
        <alias>Constellation Muru Junkii</alias>
        <look><![CDATA[<br/><br/>This constellation marks a creature with four medium-length appendages that end in feet with a very small amount of webbing, only at the base of each toe. The creature appears to have long, sharp nails. The limbs are long enough to allow the animal to keep its body suspended off of the ground for long periods of time. <br/><br/>The appearance of these appendages remind you of a komodo dragon.<br/><br/>A tail extends that is medium-length and fairly thin with little musculature. It appears to be used for balance when walking on those relatively small legs. <br/><br/>Its teeth are sparse and thick, with the sharpest ones located at the tip of the creature's snout.]]></look>
        <displayverbs type="stringlist">
          <value>Look at</value>
        </displayverbs>
        <order type="int">4</order>
        <correctvalue type="int">5</correctvalue>
        <move type="script"><![CDATA[
          topics = Split("Move to first spot;Move to second spot;Move to third spot;Move to fourth spot;Move to fifth spot;Move to sixth spot;Move to seventh spot;Move to eighth spot",";")
          msg ("<br/>The creatures described by each constellation must be place in order of which is the most ancient ( spot 1 out of 8), to which evolved latest, (spot 8 out of 8). You can give each constellation the same order value, but in finding the correct order, each constellation will need to have a different order value between 1 and 8.<br/>")
          msg ("This constellation is currently sitting in position " + Constellation04.order + " out of 8.")
          msg ("<br/>")
          show menu ("\"Which spot do you wish to place this constellation in?\"", topics, false) {
            switch (result) {
              case ("Move to first spot") {
                Constellation04.order = 1
              }
              case ("Move to second spot") {
                Constellation04.order = 2
              }
              case ("Move to third spot") {
                Constellation04.order = 3
              }
              case ("Move to fourth spot") {
                Constellation04.order = 4
              }
              case ("Move to fifth spot") {
                Constellation04.order = 5
              }
              case ("Move to sixth spot") {
                Constellation04.order = 6
              }
              case ("Move to seventh spot") {
                Constellation04.order = 7
              }
              case ("Move to eighth spot") {
                Constellation04.order = 8
              }
            }
            msg ("This constellation is now sitting in position " + Constellation04.order + " out of 8.")
          }
        ]]></move>
      </object>
      <object name="Constellation05">
        <inherit name="editor_object" />
        <alias>Constellation Sigma Bolis</alias>
        <look><![CDATA[<br/>This constellation marks a creature with two very long hind legs, and two slightly shorter front legs. The nails on the feet are long and curved upwards. The claws on the front legs are shorter. The creature appears to be able to walk on just two feet for short periods. <br/><br/>A tail extends that is long and thin, but is quite muscular and obviously capable of being used as a whip, or for grabbing and holding onto things. <br/><br/>The creature's rear teeth are virtually flat, while its front teeth are wedge-shaped, and a few fangs lie at the tip of its snout.]]></look>
        <displayverbs type="stringlist">
          <value>Look at</value>
        </displayverbs>
        <order type="int">5</order>
        <correctvalue type="int">7</correctvalue>
        <move type="script"><![CDATA[
          topics = Split("Move to first spot;Move to second spot;Move to third spot;Move to fourth spot;Move to fifth spot;Move to sixth spot;Move to seventh spot;Move to eighth spot",";")
          msg ("<br/>The creatures described by each constellation must be place in order of which is the most ancient ( spot 1 out of 8), to which evolved latest, (spot 8 out of 8). You can give each constellation the same order value, but in finding the correct order, each constellation will need to have a different order value between 1 and 8.<br/>")
          msg ("This constellation is currently sitting in position " + Constellation05.order + " out of 8.")
          msg ("<br/>")
          show menu ("\"Which spot do you wish to place this constellation in?\"", topics, false) {
            switch (result) {
              case ("Move to first spot") {
                Constellation05.order = 1
              }
              case ("Move to second spot") {
                Constellation05.order = 2
              }
              case ("Move to third spot") {
                Constellation05.order = 3
              }
              case ("Move to fourth spot") {
                Constellation05.order = 4
              }
              case ("Move to fifth spot") {
                Constellation05.order = 5
              }
              case ("Move to sixth spot") {
                Constellation05.order = 6
              }
              case ("Move to seventh spot") {
                Constellation05.order = 7
              }
              case ("Move to eighth spot") {
                Constellation05.order = 8
              }
            }
            msg ("This constellation is now sitting in position " + Constellation05.order + " out of 8.")
          }
        ]]></move>
      </object>
      <object name="Constellation06">
        <inherit name="editor_object" />
        <alias>Constellation Gamma Wazen</alias>
        <look><![CDATA[<br/><br/>This constellation marks a creature with four, very short appendages that support large, paddle-shaped flippers. The appendages are so short that the flippers almost look like rigid fins when they are not in motion.<br/><br/>A tail extends that is long and flat looking. Its teeth appear to be incredibly sharp, but thin; fragile even - probably not good for catching large prey that struggles alot. The teeth are also exceptionally numerous.]]></look>
        <displayverbs type="stringlist">
          <value>Look at</value>
        </displayverbs>
        <order type="int">6</order>
        <correctvalue type="int">1</correctvalue>
        <move type="script"><![CDATA[
          topics = Split("Move to first spot;Move to second spot;Move to third spot;Move to fourth spot;Move to fifth spot;Move to sixth spot;Move to seventh spot;Move to eighth spot",";")
          msg ("<br/>The creatures described by each constellation must be place in order of which is the most ancient ( spot 1 out of 8), to which evolved latest, (spot 8 out of 8). You can give each constellation the same order value, but in finding the correct order, each constellation will need to have a different order value between 1 and 8.<br/>")
          msg ("This constellation is currently sitting in position " + Constellation06.order + " out of 8.")
          msg ("<br/>")
          show menu ("\"Which spot do you wish to place this constellation in?\"", topics, false) {
            switch (result) {
              case ("Move to first spot") {
                Constellation06.order = 1
              }
              case ("Move to second spot") {
                Constellation06.order = 2
              }
              case ("Move to third spot") {
                Constellation06.order = 3
              }
              case ("Move to fourth spot") {
                Constellation06.order = 4
              }
              case ("Move to fifth spot") {
                Constellation06.order = 5
              }
              case ("Move to sixth spot") {
                Constellation06.order = 6
              }
              case ("Move to seventh spot") {
                Constellation06.order = 7
              }
              case ("Move to eighth spot") {
                Constellation06.order = 8
              }
            }
            msg ("This constellation is now sitting in position " + Constellation06.order + " out of 8.")
          }
        ]]></move>
      </object>
      <object name="Constellation07">
        <inherit name="editor_object" />
        <alias>Constellation Xiu Helios</alias>
        <look><![CDATA[<br/><br/>This constellation marks a creature with four short appendages that end in feet with large, webbed toes. The creature appears to have very short claws with stubby nails. The limbs are too short to act as much more than paddles for aiding the creature in squirming across the ground.<br/><br/>A tail extends that is medium-length and rounded, with a very small fin on the top and bottom, located at the tip of the tail.<br/><br/>Its teeth appear to be quite sharp, but are not particularly numerous. The front four teeth are thicker and longer than the others.]]></look>
        <displayverbs type="stringlist">
          <value>Look at</value>
        </displayverbs>
        <order type="int">7</order>
        <correctvalue type="int">3</correctvalue>
        <move type="script"><![CDATA[
          topics = Split("Move to first spot;Move to second spot;Move to third spot;Move to fourth spot;Move to fifth spot;Move to sixth spot;Move to seventh spot;Move to eighth spot",";")
          msg ("This constellation is currently sitting in position " + Constellation07.order + " out of 8.")
          msg ("<br/>")
          show menu ("\"Which spot do you wish to place this constellation in?\"", topics, false) {
            switch (result) {
              case ("Move to first spot") {
                Constellation07.order = 1
              }
              case ("Move to second spot") {
                Constellation07.order = 2
              }
              case ("Move to third spot") {
                Constellation07.order = 3
              }
              case ("Move to fourth spot") {
                Constellation07.order = 4
              }
              case ("Move to fifth spot") {
                Constellation07.order = 5
              }
              case ("Move to sixth spot") {
                Constellation07.order = 6
              }
              case ("Move to seventh spot") {
                Constellation07.order = 7
              }
              case ("Move to eighth spot") {
                Constellation07.order = 8
              }
            }
            msg ("This constellation is now sitting in position " + Constellation07.order + " out of 8.")
          }
        ]]></move>
      </object>
      <object name="Constellation08">
        <inherit name="editor_object" />
        <alias>Constellation Hyperio Scionus</alias>
        <look><![CDATA[<br/>This constellation marks a creature with four long appendages that end in sharp claws. The nails appear to be drawn up, so as not to impede with running or walking. This reminds you of a velociraptor.<br/><br/>The limbs are becoming particularly long, but the creature's body is not enourmous, putting little stress on the elongated legs.<br/><br/>A tail extends that is medium-length and thin, but it appears to be limber and maybe even prehensile, which might allow it to pick up small objects. <br/><br/>The creature's rear teeth are not nearly as sharp as its front teeth.]]></look>
        <displayverbs type="stringlist">
          <value>Look at</value>
        </displayverbs>
        <order type="int">8</order>
        <correctvalue type="int">6</correctvalue>
        <move type="script"><![CDATA[
          topics = Split("Move to first spot;Move to second spot;Move to third spot;Move to fourth spot;Move to fifth spot;Move to sixth spot;Move to seventh spot;Move to eighth spot",";")
          msg ("<br/>The creatures described by each constellation must be place in order of which is the most ancient ( spot 1 out of 8), to which evolved latest, (spot 8 out of 8). You can give each constellation the same order value, but in finding the correct order, each constellation will need to have a different order value between 1 and 8.<br/>")
          msg ("This constellation is currently sitting in position " + Constellation08.order + " out of 8.")
          msg ("<br/>")
          show menu ("\"Which spot do you wish to place this constellation in?\"", topics, false) {
            switch (result) {
              case ("Move to first spot") {
                Constellation08.order = 1
              }
              case ("Move to second spot") {
                Constellation08.order = 2
              }
              case ("Move to third spot") {
                Constellation08.order = 3
              }
              case ("Move to fourth spot") {
                Constellation08.order = 4
              }
              case ("Move to fifth spot") {
                Constellation08.order = 5
              }
              case ("Move to sixth spot") {
                Constellation08.order = 6
              }
              case ("Move to seventh spot") {
                Constellation08.order = 7
              }
              case ("Move to eighth spot") {
                Constellation08.order = 8
              }
            }
            msg ("This constellation is now sitting in position " + Constellation08.order + " out of 8.")
          }
        ]]></move>
      </object>
      <object name="HintAndPrimer">
        <inherit name="editor_object" />
        <look><![CDATA[You see a help beacon hovering nearby. It offers you advice, if you have difficulty ordering the constellations. <br/><br/>]]></look>
        <displayverbs type="stringlist">
          <value>Look at</value>
        </displayverbs>
        <alias>Help Beacon</alias>
        <requestcurrentconstellationorder type="script"><![CDATA[
          msg ("<i>(For continuity, the constellation's order is displayed in the same order that your \"objects or places\" lists them.</i><br/>")
          msg ("Constellation Muru Nakat currently has an order value of " + Constellation01.order + " out of 8.")
          msg ("Constellation Goyo Vignat currently has an order value of " + Constellation02.order + " out of 8.")
          msg ("Constellation Bios Magniscurrently has an order value of " + Constellation03.order + " out of 8.")
          msg ("Constellation Muru Junkii currently has an order value of " + Constellation04.order + " out of 8.")
          msg ("Constellation Sigma Bolis currently has an order value of " + Constellation05.order + " out of 8.")
          msg ("Constellation Gamma Wazen has an order value of " + Constellation06.order + " out of 8.")
          msg ("Constellation Xiu Helios currently has an order value of " + Constellation07.order + " out of 8.")
          msg ("Constellation Hyperio Scionus currently has an order value of " + Constellation08.order + " out of 8.")
        ]]></requestcurrentconstellationorder>
        <requestorderwithhelp type="script"><![CDATA[
          msg ("Constellation Muru Nakat currently has an order value of " + Constellation01.order + " out of 8.")
          if (Constellation01.order = 4) {
            msg ("<b>This the correct order for this constellation.</b>")
          }
          else if (Constellation01.order = 1 or Constellation01.order = 2 or Constellation01.order= 3 or Constellation01.order = 5 or Constellation01.order = 6 or Constellation01.order = 7 or Constellation01.order = 8) {
            msg ("<b>Incorrect.</b>")
          }
          msg ("Constellation Goyo Vignat currently has an order value of " + Constellation02.order + " out of 8.")
          if (Constellation02.order = 8) {
            msg ("<b>This the correct order for this constellation.</b>")
          }
          else if (Constellation02.order = 1 or Constellation02.order = 2 or Constellation02.order= 3 or Constellation02.order = 4 or Constellation02.order = 5 or Constellation02.order = 6 or Constellation02.order = 7) {
            msg ("<b>Incorrect.</b>")
          }
          msg ("Constellation Bios Magniscurrently has an order value of " + Constellation03.order + " out of 8.")
          if (Constellation03.order = 2) {
            msg ("<b>This the correct order for this constellation.</b>")
          }
          else if (Constellation03.order = 1 or Constellation03.order = 8 or Constellation03.order= 3 or Constellation03.order = 4 or Constellation03.order = 5 or Constellation03.order = 6 or Constellation03.order = 7) {
            msg ("<b>Incorrect.</b>")
          }
          msg ("Constellation Muru Junkii currently has an order value of " + Constellation04.order + " out of 8.")
          if (Constellation04.order = 5) {
            msg ("<b>This the correct order for this constellation.</b>")
          }
          else if (Constellation04.order = 1 or Constellation04.order = 2 or Constellation04.order= 3 or Constellation04.order = 4 or Constellation04.order = 6 or Constellation04.order = 7 or Constellation04.order = 8) {
            msg ("<b>Incorrect.</b>")
          }
          msg ("Constellation Sigma Bolis currently has an order value of " + Constellation05.order + " out of 8.")
          if (Constellation05.order = 7) {
            msg ("<b>This the correct order for this constellation.</b>")
          }
          else if (Constellation05.order = 1 or Constellation05.order = 2 or Constellation05.order= 3 or Constellation05.order = 4 or Constellation05.order = 5 or Constellation05.order = 6 or Constellation05.order = 8) {
            msg ("<b>Incorrect.</b>")
          }
          msg ("Constellation Gamma Wazen has an order value of " + Constellation06.order + " out of 8.")
          if (Constellation06.order = 1) {
            msg ("<b>This the correct order for this constellation.</b>")
          }
          else if (Constellation06.order = 2 or Constellation06.order= 3 or Constellation06.order = 4 or Constellation06.order = 5 or Constellation06.order = 6 or Constellation06.order = 7 or Constellation06.order = 8) {
            msg ("<b>Incorrect.</b>")
          }
          msg ("Constellation Xiu Helios currently has an order value of " + Constellation07.order + " out of 8.")
          if (Constellation07.order = 3) {
            msg ("<b>This the correct order for this constellation.</b>")
          }
          else if (Constellation07.order = 1 or Constellation07.order = 2 or Constellation07.order= 4 or Constellation07.order = 5 or Constellation07.order = 6 or Constellation07.order = 7 or Constellation07.order = 8) {
            msg ("<b>Incorrect.</b>")
          }
          msg ("Constellation Hyperio Scionus currently has an order value of " + Constellation08.order + " out of 8.")
          if (Constellation08.order = 6) {
            msg ("<b>This the correct order for this constellation.</b>")
          }
          else if (Constellation08.order = 1 or Constellation08.order = 2 or Constellation08.order= 3 or Constellation08.order = 4 or Constellation08.order = 5 or Constellation08.order = 7 or Constellation08.order = 8) {
            msg ("<b>Incorrect.</b>")
          }
        ]]></requestorderwithhelp>
        <askforadvice type="script"><![CDATA[
          msg ("First, the beacon offers a note about the concept behind evolution that should help in ordering the creatures from the earliest ancestor to the most recent species: <br/><br/>Evolution is not to be confused with adaptation. Adaptation is the process that a creature undergoes to live in a changing environment. Adaptation occurs several times within the life of a single organism. <br/><br/>Evolution, on the other hand, occurs over generations. Evolution occurs not because a creature desires it to, or needs it to. Evolution simply happens. And if the evolved trait (mutation) happens to be useful, then that trait is passed on to the organism's offspring. The overwhelming majority of the time, a mutation is not beneficial to a creature, and is in fact harmful. This makes survival difficult, and passage of a nasty mutation onto offspring very unlikely. <br/><br/>The beacon sputters around your head, telling you that the following is a hint. \"Only use this if you must.\" it says.<br/><br/>Remember the primer that stated the creature evolved at a time when the great majority of species lived in the ocean, as opposed to on the land masses. If you think critcally about that statement, then you can pose this question, and then answer it; \"If most of the life is in the ocean, then what is more likely to happen; A) a species evolves from an aquatic one to a terrestrial one - to fill the empty niches available on land, or B) A species evolves from a terrestrial one to an aquatic one - to compete with the plethora of ocean-dwelling species already established. <br/><br/>The answer to this question is much more likely to be 'A'. That's not to say that 'B' can't or won't happen, but it is significantly less likely. With this in mind, you can much more easily order the organisms in terms of their evolution. Using logic to determine which traits would help an aquatic species as opposed to a terrestrial one, you can start ordering them in that manner.<br/><br/>Finally. the beacon says, \"If you still have difficulty, then 'request order with help' to have me display the current constellations and their orders, which I will tell you is correct, or incorrect.\"<br/>")
        ]]></askforadvice>
      </object>
      <object name="Portal">
        <inherit name="editor_object" />
        <alias>portal</alias>
        <look><![CDATA[This portal has appeared beyond the constellations. It is a pulsating disk of green energy. <br/><br/>A voice in the back of your mind tells you that this portal will open when you have the constellations in the correct order.]]></look>
        <displayverbs type="stringlist">
          <value>Look at</value>
        </displayverbs>
        <visible type="boolean">false</visible>
        <activate type="script"><![CDATA[
          if (Constellation01.order = 4) {
            if (Constellation02.order = 8) {
              if (Constellation03.order = 2) {
                if (Constellation04.order = 5) {
                  if (Constellation05.order = 7) {
                    if (Constellation06.order = 1) {
                      if (Constellation07.order = 3) {
                        if (Constellation08.order = 6) {
                          ClearScreen
                          msg ("You have correctly ordered the constellations. The portal widens and a rift opens from its center. Your body rockets into the portal, and everything goes dark.")
                          msg ("<br/>You open your eyes and find yourself back in the Medical Station. Ziggy and Duffy  are in exactly the same position as they were when you touched the device. Wherever you were - whatever just happened - must have transpired in an instant, here.<br/><br/>The strange device has disappeared.")
                          wait {
                            MedicalStation.visitedvoid = True
                            MoveObject (player, MedicalStation)
                            AddToInventory (MysteriousOrb)
                          }
                        }
                        else if (Constellation08.order = 2 or Constellation08.order= 3 or Constellation08.order = 4 or Constellation08.order = 5 or Constellation08.order = 1 or Constellation08.order = 7 or Constellation08.order = 8) {
                          msg ("The portal does not react. It seems that you do not have the constellations in the correct order.")
                        }
                      }
                      else if (Constellation07.order = 2 or Constellation07.order= 1 or Constellation07.order = 4 or Constellation07.order = 5 or Constellation07.order = 6 or Constellation07.order = 7 or Constellation07.order = 8) {
                        msg ("The portal does not react. It seems that you do not have the constellations in the correct order.")
                      }
                    }
                    else if (Constellation06.order = 2 or Constellation06.order= 3 or Constellation06.order = 4 or Constellation06.order = 5 or Constellation06.order = 6 or Constellation06.order = 7 or Constellation06.order = 8) {
                      msg ("The portal does not react. It seems that you do not have the constellations in the correct order.")
                    }
                  }
                  else if (Constellation05.order = 1 or Constellation05.order = 2 or Constellation05.order= 3 or Constellation05.order = 4 or Constellation05.order = 5 or Constellation05.order = 6 or Constellation05.order = 8) {
                    msg ("The portal does not react. It seems that you do not have the constellations in the correct order.")
                  }
                }
                else if (Constellation04.order = 1 or Constellation04.order = 2 or Constellation04.order= 3 or Constellation04.order = 4 or Constellation04.order = 6 or Constellation04.order = 7 or Constellation04.order = 8) {
                  msg ("The portal does not react. It seems that you do not have the constellations in the correct order.")
                }
              }
              else if (Constellation03.order = 1 or Constellation03.order = 8 or Constellation03.order= 3 or Constellation03.order = 4 or Constellation03.order = 5 or Constellation03.order = 6 or Constellation03.order = 7) {
                msg ("The portal does not react. It seems that you do not have the constellations in the correct order.")
              }
            }
            else if (Constellation02.order = 1 or Constellation02.order = 2 or Constellation02.order= 3 or Constellation02.order = 4 or Constellation02.order = 5 or Constellation02.order = 6 or Constellation02.order = 7) {
              msg ("The portal does not react. It seems that you do not have the constellations in the correct order.")
            }
          }
          else if (Constellation01.order = 1 or Constellation01.order = 2 or Constellation01.order= 3 or Constellation01.order = 5 or Constellation01.order = 6 or Constellation01.order = 7 or Constellation01.order= 8) {
            msg ("The portal does not react. It seems that you do not have the constellations in the correct order.")
          }
        ]]></activate>
      </object>
    </object>
  </object>
  <verb>
    <property>activate</property>
    <pattern>activate</pattern>
    <defaultexpression>"You can't activate " + object.article + "."</defaultexpression>
  </verb>
  <object name="Container">
    <inherit name="editor_object" />
    <object name="MysteriousOrb">
      <inherit name="editor_object" />
      <look><![CDATA[A mysterious orb, cold to the touch. It's the size of a marble.
<br/><br/>The voices in the cold void didn't explain its use, or if it even has a purpose. Still, it weighs functionally nothing, and can't hurt to keep - until you figure out its use.                                                                                                                                                                                                                  ]]></look>
      <alias>mysterious glowing orb</alias>
    </object>
    <object name="mirror">
      <inherit name="editor_object" />
      <scenery type="boolean">false</scenery>
      <visible />
      <look>A cracked mirror of medium size.</look>
      <takemsg>You take the mirror.</takemsg>
      <take />
      <use />
      <selfuseon type="scriptdictionary" />
    </object>
    <object name="EightBall">
      <inherit name="editor_object" />
      <alias>magic 8 ball</alias>
      <look>It's a magic 8 ball. It looks like it might still work.</look>
      <take />
      <takemsg>You take the magic 8 ball. Perhaps it has valuable answers to your many questions.</takemsg>
      <inventoryverbs type="stringlist">
        <value>Look at</value>
        <value>Drop</value>
      </inventoryverbs>
      <response>value</response>
      <responsenumber type="int">0</responsenumber>
      <ask type="script">
        msg ("What would you like to ask the magic 8 ball?")
        get input {
          EightBall.responsenumber = GetRandomInt(1,10)
          switch (EightBall.responsenumber) {
            case (1) {
              EightBall.response = "It is certain"
            }
            case (2) {
              EightBall.response = "It is decidedly so"
            }
            case (3) {
              EightBall.response = "Without a doubt"
            }
            case (4) {
              EightBall.response = "Yes  definitely"
            }
            case (5) {
              EightBall.response = "You may rely on it"
            }
            case (6) {
              EightBall.response = "As I see it, yes"
            }
            case (7) {
              EightBall.response = "Most likely"
            }
            case (8) {
              EightBall.response = "Outlook good"
            }
            case (9) {
              EightBall.response = "Yes"
            }
            case (10) {
              EightBall.response = "Reply hazy, try again"
            }
            case (11) {
              EightBall.response = " Ask again later"
            }
            case (12) {
              EightBall.response = "Better not tell you now"
            }
            case (13) {
              EightBall.response = "Cannot predict now"
            }
            case (14) {
              EightBall.response = "Concentrate and ask again"
            }
            case (15) {
              EightBall.response = "Don't count on it"
            }
            case (16) {
              EightBall.response = "My reply is no"
            }
            case (17) {
              EightBall.response = "My sources say no"
            }
            case (18) {
              EightBall.response = "Outlook not so good"
            }
            case (19) {
              EightBall.response = "Very doubtful"
            }
            case (20) {
              EightBall.response = "Signs point to yes"
            }
            case (21) {
              EightBall.response = "Ask me, "riddle""
            }
          }
          msg ("         ")
          msg ("You shake the magic 8 ball and ask it, '" + result + "'.")
          SetTimeout (2) {
            msg ("The magic 8 ball responds, '" + EightBall.response + "'.")
          }
        }
      </ask>
    </object>
    <object name="eightballnote">
      <inherit name="editor_object" />
      <alias>magic 8 ball note</alias>
      <look type="string"></look>
      <inventoryverbs type="stringlist">
        <value>Look at</value>
        <value>Drop</value>
      </inventoryverbs>
    </object>
    <object name="GeigerCounter">
      <inherit name="editor_object" />
      <look>This Geiger counter seems to still be operational. Who knows how it might come in handy.</look>
      <take />
      <alias>Geiger counter</alias>
      <use />
      <selfuseon type="scriptdictionary">
        <item key="canister"><![CDATA[
          if (canister.opened = True) {
            msg ("<br/>You use the Geiger counter on the opened canister.The device frantically clicks, warning you of a mildly radioactive substance inside.")
            if (game.pov.parent = MilitaryBuildingHallway) {
              msg ("<br/>Suddenly, a loud feeback noise eminates from the speaker console near the locked door in this hallway. The lock snaps and the door gently flings open, revealing a control room.")
              UnlockExit (control room)
            }
            else {
              msg ("<br/>Nothing else appears to be happening. Maybe you should try this again somewhere else.")
            }
          }
          else {
            msg ("You use the Geiger counter on the closed canister. The counter does not react, emitting a gentle and random click every few seconds. The lead container appears to be blocking all radiation from the metal inside.")
          }
        ]]></item>
      </selfuseon>
    </object>
    <object name="RadiationSuit">
      <inherit name="editor_object" />
      <look>This suit is pretty heavy. That fact seems to indicate that it is some sort of radiation suit with lead used for neutralizing alpha and beta waves.</look>
      <worn type="boolean">false</worn>
      <inventoryverbs type="stringlist">
        <value>Look at</value>
      </inventoryverbs>
      <take />
      <alias>radiation suit</alias>
      <wear type="script">
        if (not Got(RadiationSuit)) {
          msg ("You need to be carrying the suit to wear it.")
        }
        else {
          if (RadiationSuit.worn = False) {
            msg ("You put on the radiation suit and seal it.")
            RadiationSuit.worn = True
          }
          else {
            msg ("You are already wearing the suit.")
          }
        }
      </wear>
      <takeoff type="script">
        if (RadiationSuit.worn = False) {
          if (not Got(RadiationSuit)) {
            msg ("You need to be carrying the suit to do that.")
          }
          else {
            msg ("You are not wearing the suit.")
          }
        }
        else {
          if (game.pov.parent = UndergroundRoom1) {
            msg ("The radiation levels in this room are too high to remove your suit. You would receive a lethal dose in a matter of seconds.")
          }
          else {
            if (game.pov.parent = UndergroundRoom2) {
              msg ("The radiation levels in this room are too high to remove your suit. You would receive a lethal dose in a matter of seconds.")
            }
            else {
              if (RadiationSuit.worn = True) {
                msg ("You take the radiation suit off and store it.")
                RadiationSuit.worn = False
              }
              else {
              }
            }
          }
        }
      </takeoff>
    </object>
  </object>
  <verb>
    <property>requestcurrentconstellationorder</property>
    <pattern>request current constellation order</pattern>
    <defaultexpression>"You can't request current constellation order " + object.article + "."</defaultexpression>
  </verb>
  <verb>
    <property>requestorderwithcorrect/incorrect</property>
    <pattern>request order with correct/incorrect</pattern>
    <defaultexpression>"You can't request order with correct/incorrect " + object.article + "."</defaultexpression>
  </verb>
  <verb>
    <property>requestorderwithhelp</property>
    <pattern>request order with help</pattern>
    <defaultexpression>"You can't request order with help " + object.article + "."</defaultexpression>
  </verb>
  <verb>
    <property>askforadvice</property>
    <pattern>ask for advice</pattern>
    <defaultexpression>"You can't ask for advice " + object.article + "."</defaultexpression>
  </verb>
  <verb>
    <property>openhatch</property>
    <pattern>open hatch</pattern>
    <defaultexpression>"You can't open hatch " + object.article + "."</defaultexpression>
  </verb>
  <verb>
    <property>completeskeleton</property>
    <pattern>complete skeleton</pattern>
    <defaultexpression>"You can't complete skeleton " + object.article + "."</defaultexpression>
  </verb>
  <command>
    <pattern>move player</pattern>
    <script>
      MoveObject (player, MediumPathStreets)
    </script>
  </command>
  <verb>
    <property>standonscale</property>
    <pattern>stand on scale</pattern>
    <defaultexpression>"You can't stand on scale " + object.article + "."</defaultexpression>
  </verb>
  <verb>
    <property>cleanpanels</property>
    <pattern>clean panels</pattern>
    <defaultexpression>"You can't clean panels " + object.article + "."</defaultexpression>
  </verb>
  <verb>
    <property>movepanelsintosun</property>
    <pattern>move panels into sun</pattern>
    <defaultexpression>"You can't move panels into sun " + object.article + "."</defaultexpression>
  </verb>
  <verb>
    <property>flip</property>
    <pattern>flip</pattern>
    <defaultexpression>"You can't flip " + object.article + "."</defaultexpression>
  </verb>
  <command name="Help">
    <pattern>help</pattern>
    <script><![CDATA[
      msg ("Are you stuck, or just in need of a command template?<br/><br/><u><b>Command Template:</b></u><br/><b>Ask</b> <i>character</i> <b>About </b> <i>object/item/scenery</i><br/><b>Use</b> <i>item</i> <b>on</b> <i>object/item/scenery</i><br/><b>Take</b> <i>item</i><br/><b>Move</b> <i>object</i><br/><b>Clear</b> <i>object</i><br/><b>Read</b> <i>item</i><br/><b>Hint</b><br/>\"Hint\" will give you a hint for puzzles that appear within your current section. Sections within WAKE are defined as \"Parts\" (ex. Part 1, Part 2, etc.). If the hints don't help enough to solve the puzzles, a walkthrough is available from the game's listing page. As one might imagine, the walkthrough is a spoiler for all major parts of the game; but aspects of the game that are not necessary to completion are not covered in the original walkthrough. They can only be accessed through exploration, or possibly, fan-made walkthroughs and advice.<br/><br/>(Also, there are hidden commands that are not necessary to completion or enjoyment of the game, but that reward people who try to find them)<br/><br/>Important Notes #1<br/>-The puzzle types in Wake are not in the \"Escape the Room\" format. Not only that, but the objects or information that is absolutely necessary, all exists within a short sequence of locations. At multiple parts in the game, you will not be able to backtrack. So everything that is necessary to a puzzle's completion is nearby. Sometimes the answer is not a hidden object, but your own problem solving capabilities, based on hints that you gather. <br/><br/>The game progresses in a manner similar to a console shooter. The main areas have a linear path, but each of these main areas often has a plethora of side locations to explore.<br/><br/>Most locations have hidden items. Many of these items are necessary, but some of them are part of the story environment. Some will reward you for exploration with an object that may come in handy - or - some of the rewards are extra plot that fleshes out the story even more.<br/><br/>Important Note #2<br/>-Not all possible commands are listed under the \"objects and places\" or \"inventory\" lists on your Quest, Heads Up Display (HUD). Some things require you to use a command to probe whether or not a response is available. For example; if a description of a scene/location/item describes something specific, that you don't see on the HUD, or as an active conversation, then you may want to try to search for a hidden interactions. <br/><br/>A good example of this occurs in the second location of the game, called Medical Station, there is a crate called \"Alien Supply Crate\". The player obtains this key by talking to Duffy, who will then give the you the key. However, the conversation is not active when choosing to \"talk to\" him. You must type, \"Ask Duffy About Key\" to initiate this conversation.<br/><br/>However, if you use the same command at the previous location, Duffy will not have this special conversation available.<br/>")
    ]]></script>
  </command>
  <verb>
    <property>opendoor</property>
    <pattern>open door</pattern>
    <defaultexpression>"You can't open door " + object.article + "."</defaultexpression>
  </verb>
  <object name="pawnshop">
    <inherit name="editor_room" />
    <alias>"esmond's" Pawn Shop</alias>
    <look>You see a shop to your left. Years of sunlight and weather have bleached the letters and worn them down to near-nothing, requiring you to afford more than a glance to read them. It says, "esmond's Pawn Shop". The first letter is missing. Probably a "D".</look>
    <displayverbs type="stringlist">
      <value>Look at</value>
    </displayverbs>
    <description>It's a thrift store. There are rows of glass cases with decaying objects and oddities. Gravity has caused the glass panels to sag over such a long period of time, becoming thicker at the bottom, and thinner at the top.</description>
    <object name="painting behind counter">
      <inherit name="editor_object" />
      <look><![CDATA[The actual painting is a garbled mess of colors, with mold covering much of the canvas. The frame is rotting, but a metal plaque on its bottom reads, <br/><br/>"To Desmond, by and from Jennifer Barrister.<br/>-A Lover's Embrace" <br/><br/>A small heart with an arrow piercing it is engraved into the wall next to the painting. The arrow points to behind the painting.]]></look>
      <displayverbs type="stringlist">
        <value>Look at</value>
      </displayverbs>
      <flip type="script"><![CDATA[
        msg ("You flip the painting, and find a message written into the backboard.<br/><br/>The message says, \"I knew youd come looking for answers here first, in your shop. Find the place where the two lines converge. The place we parted every morning and reunited every evening. <br/><br/>But first, look in your safe. I know you never got around to using it, so I gave it a six digit code; but the code is simple. If I know you - and trust me I do - only you could figure it out. <br/><br/>Just remember when I told you to weigh your options carefully, before spending tens of thousands on property in the city. And you said, 'Location, location, location.' Turn the painting back when you're done. I dont want someone or something following you.<br/><br/>")
      ]]></flip>
    </object>
    <object name="register">
      <inherit name="editor_object" />
      <inherit name="container_open" />
      <displayverbs type="stringlist">
        <value>Look at</value>
      </displayverbs>
      <close type="boolean">false</close>
      <open type="boolean">false</open>
      <isopen />
      <hidechildren />
      <look>An old cash register.</look>
      <object name="coins">
        <inherit name="editor_object" />
        <look>They are an assortment of pennies, nickels, dimes, and quarters.</look>
        <takemsg>You speculate that being the last human alive might reduce the value of currency, but you take the coins anyway.</takemsg>
        <take />
      </object>
    </object>
    <object name="Safe">
      <inherit name="editor_object" />
      <inherit name="container_closed" />
      <displayverbs type="stringlist">
        <value>Look at</value>
      </displayverbs>
      <close type="boolean">false</close>
      <open type="boolean">false</open>
      <isopen type="boolean">false</isopen>
      <locked />
      <autoopen type="boolean">false</autoopen>
      <autounlock type="boolean">false</autounlock>
      <alias>safe</alias>
      <playercombo>0</playercombo>
      <actualcombo>147888</actualcombo>
      <unlocked type="boolean">false</unlocked>
      <nokeymessage type="string"></nokeymessage>
      <listchildren type="boolean">false</listchildren>
      <unlock type="script"><![CDATA[
        if (Safe.unlocked = False) {
          msg ("This safe requires a seven-digit combination.<br/><br/><i>(Enter the seven-digit combination; integers only)</i>")
          get input {
            msg (result)
            if (result = "147888") {
              msg ("<br/>You open the safe. It appears to have been cleared out, except for a cracked mirror propped against the back, and a magic 8 ball.")
              MoveObject (mirror, pawnshop)
              MoveObject (EightBall, pawnshop)
              Safe.unlocked = True
            }
            else {
              msg ("<br/>This combination didn't work. I should try again.<br/><br/>(Choose \"unlock\" to try again.)")
            }
          }
        }
        else {
          msg ("The safe is already unlocked.")
        }
      ]]></unlock>
      <look type="script">
        if (Safe.unlocked = False) {
          msg ("It's a medium-sized safe. It's currently locked.")
        }
        else {
          msg ("The safe was cleared out, except for a medium-sized mirror and a magic 8 ball.")
        }
      </look>
    </object>
    <object name="CeramicPigeon">
      <inherit name="editor_object" />
      <displayverbs type="stringlist">
        <value>Look at</value>
      </displayverbs>
      <look><![CDATA[It is a ceramic replica of an unusual pigeon; some species you don't recognize. <br/><br/>A plaque at its feet reads, <br/><br/>"Martha, the last of her species. Cincinnati, Ohio. 1914" <br/><br/>Under this is a quote.<br/><br/>"'Men still live who, in their youth, remember pigeons. Trees still live who, in their youth, were shaken by a living wind. But a decade hence only the oldest oaks will remember, and at long last only the hills will know.'<br/>-Aldo Leopold"]]></look>
      <alias>unusual ceramic pigeon</alias>
    </object>
    <object name="scale">
      <inherit name="editor_object" />
      <displayverbs type="stringlist">
        <value>Look at</value>
      </displayverbs>
      <look>This scale is an old pre-digital age model. It looks like it might still work, although you highly doubt it would be all that accurate.</look>
      <used type="boolean">false</used>
      <standonscale type="script"><![CDATA[
        msg ("<br/>You stand on the scale. The little, red plastic arm slides along the white background, finally coming to rest at a weight of \"147\". You assume that this scale must be measuring in pounds, since 147 kilograms would be absurd. At the same time, you note that your body size is not condusive with weighing 147 pounds.")
        scale.used = True
      ]]></standonscale>
      <useon type="scriptdictionary">
        <item key="CellPhone"><![CDATA[
          if (scale.used = True) {
            msg ("<br/>You place the cell phone on the scale. The red plastic arm slides along the white background, stopping at 147; again. A scale would simply be off of the actual weight by some value - if it needed recalibration. This scale is not off. Somehow, 147 was exactly where it was supposed to be.<br/><br/>You say to yourself. \"Valuable interface with human technology? - damn straight.\"")
          }
          else {
            msg ("<br/>I should weigh myself first.")
          }
        ]]></item>
      </useon>
    </object>
    <exit alias="east" to="LetThereBeLight">
      <inherit name="eastdirection" />
    </exit>
  </object>
  <object name="MilitaryComplexLobby">
    <inherit name="editor_room" />
    <alias>building through the unlocked iron door</alias>
    <usedefaultprefix />
    <descprefix>You have entered</descprefix>
    <description type="script"><![CDATA[
      ClearScreen
      firsttime {
        SetTimeout (1) {
          msg ("<br/>The iron door has shut behind you and the aliens, and the controls are busted in here. <br/><br/>There's no going back now. ")
          SetTimeout (5) {
            msg ("<br/>You are in the atrium of what appears to be a repurposed military complex, as large metal crates of ammunition line the far wall. There are rusted shell casings all over the floor here.")
            SetTimeout (6) {
              msg ("<br/>The musty, choking odor of mold and decay drifts through the stagnant air. You look up, where a large hole has been thrashed in the reinforced glass dome-ceiling.")
              SetTimeout (6) {
                play sound ("EerieSound.mp3", false, false)
                msg ("<br/>The eerie screech of some nearby animal pierces the heavy air.")
                msg ("<br/>Duffy tenses, reaching for a device attached to the side of his backpack. Ziggy looks around the room, making sure the creature is indeed as far away as it sounds.")
                SetTimeout (7) {
                  msg ("<br/>\"What was that,\" Ziggy asks.<br/><br/>You wait quietly for several moments, trying to seperate the gentle, lazy  noises of your environment from anything that might be lurking in the structure.")
                  SetTimeout (6) {
                    msg ("<br/>You hear a low, rumbling creak that reverberates through the building, as it appears to be warping under years of neglect. But there is no sign of whatever made that screech.")
                    SetTimeout (6) {
                      msg ("\"Doesn't matter what it is,\" Duffy replies. \"if it ends up at the wrong end of this.\" Duffy readies a weapon of some sort, which begins to glow. A thin purple mist seems to whisk off the device's muzzle.")
                      SetTimeout (6) {
                        msg ("<br/>Several areas seem to be accessible from here. A massive steel door sits at the bottom of a nearby ramp, blocking the entrance to some underground facility. There's a hallway to the north and an auditorium to the east. Duffy and Ziggy are discussing something about what their scans have detected.")
                        MakeExitVisible (auditorium)
                        MakeExitVisible (bunker entrance)
                        MakeExitVisible (courtyard)
                        MakeExitVisible (hallway)
                        MakeObjectVisible (ArmmoCrateStacks)
                        MakeObjectVisible (bunkerdoor)
                        MakeObjectVisible (skeletalfragments)
                        MoveObject (DuffyMain, MilitaryComplexLobby)
                        MoveObject (ZiggyMain, MilitaryComplexLobby)
                        do (ZiggyMainMilitaryComplexScans, "show")
                      }
                    }
                    msg ("")
                  }
                }
              }
            }
          }
        }
      }
      otherwise {
        msg ("<br/>You're in the lobby of what appears to be a repurposed military complex, as large metal crates of ammunition line the far wall. There are rusted shell casings all over the floor here,a long with several skeletons and ruined weaponry.<br/><br/>The musty, choking odor of mold and decay drifts through the stagnant air. A low, rumbling creak reverberates through the structure, as it appears to be warping under years of neglect.<br/><br/>You look up, where a large hole has been thrashed in the reinforced glass dome-ceiling.<br/><br/>Several areas seem to be accessible from here. A massive steel door sits at the bottom of a nearby ramp, blocking the entrance to some underground facility. There's a hallway to the north and an auditorium to the east.")
      }
    ]]></description>
    <beforeenter type="script">
      firsttime {
      }
      otherwise {
        MoveObject (ZiggyMain, MilitaryComplexLobby)
        MoveObject (DuffyMain, MilitaryComplexLobby)
      }
    </beforeenter>
    <beforefirstenter type="script"><![CDATA[
      ClearScreen
      firsttime {
        msg ("<b><font size=\"8\" color=\"midnightblue\">Part Three:</font></b>")
        msg ("-They Are Watching-")
        msg ("<br/>\"It's inside. It writhes and festers, warping the threads that bind the mind and soul. It separates them, freeing the flesh and ensnaring the ethereal.\"<br/><i>-passage from a journal found on the lap of a skeleton</i>")
        msg ("<br/><br/><i>(Press any key to continue.)</i>")
        wait {
        }
      }
      otherwise {
        MoveObject (ZiggyMain, MilitaryComplexLobby)
        MoveObject (DuffyMain, MilitaryComplexLobby)
      }
    ]]></beforefirstenter>
    <exit name="hallway" alias="north" to="MilitaryBuildingHallway">
      <inherit name="northdirection" />
      <visible type="boolean">false</visible>
    </exit>
    <exit name="courtyard" alias="west" to="LetThereBeLight">
      <inherit name="westdirection" />
      <locked />
      <lockmessage>The iron door is shut tight behind you, and the door controls on this side are busted. There's no going back, now.</lockmessage>
      <visible type="boolean">false</visible>
    </exit>
    <exit name="auditorium" alias="east" to="MilitaryBuildingAuditorium">
      <inherit name="eastdirection" />
      <visible type="boolean">false</visible>
    </exit>
    <exit name="bunker entrance" alias="northeast" to="MilitaryBunker">
      <inherit name="northeastdirection" />
      <locked />
      <lockmessage>This way is currently blocked by a massive steel door. </lockmessage>
      <visible type="boolean">false</visible>
    </exit>
    <object name="ArmmoCrateStacks">
      <inherit name="editor_object" />
      <visible type="boolean">false</visible>
      <alias>stacks of munition crates</alias>
    </object>
    <object name="atriumceiling">
      <inherit name="editor_object" />
      <visible type="boolean">false</visible>
      <alias>ceiling</alias>
      <look>You look at the roof again. The reinforced glass roofing took a powerful blow to rupture in that manner. The ceiling appears to teeter on the verge of collapse. You wonder if spending too much time in the atrium might be hazardous to your well-being.</look>
    </object>
    <object name="skeletalfragments">
      <inherit name="editor_object" />
      <visible type="boolean">false</visible>
      <alias>skeletal fragments</alias>
      <look type="script">
        msg ("There are pieces of skeletons littering the atrium floor. Bones are scattered amongst the years of detritus and plant growth taking root on the substrate; and under the sunlight from the broken roof. Many of the bones appear to be from humans; many - but not all.")
      </look>
    </object>
    <object name="bunkerdoor">
      <inherit name="editor_object" />
      <alias>steel bunker door</alias>
      <visible type="boolean">false</visible>
      <look type="script"><![CDATA[
        firsttime {
          msg ("The door is wide; about two car lengths. It is almost fifteen feet tall, and appears to be built to withstand the heaviest ordinances. This door, unlike the one you accessed earlier, has full power. You don't see any keypad or obvious interface near this door.")
          msg ("<br/>\"This door's security has a feedback loop vulnerability,\" Duffy says while  interacting with his wrist scanner. He pauses a moment. \"Well maybe not a weakness - it seems to be designed this way.\"<br/><br/>\"What do you mean,\" you ask. \"Can we get through it?\"<br/><br/>\"Yes,\" Duffy replies. \"We just need to find the power source and initiate a reset. That should cause all functioning doors to open.\"<br/><br/>\"Should?\" Ziggy asks.<br/><br/>\"What did you humans once say?\" Duffy asks, looking to you. \"Fingers crossed?\"")
        }
        otherwise {
          msg ("The door is wide; about two car lengths. It is almost fifteen feet tall, and appears to be built to withstand the heaviest ordinances. This door, unlike the one you accessed earlier, has full power. You don't see any keypad or obvious interface near this door.")
        }
      ]]></look>
    </object>
  </object>
  <verb>
    <property>entercode</property>
    <pattern>enter code</pattern>
    <defaultexpression>"You can't enter code " + object.article + "."</defaultexpression>
  </verb>
  <object name="GameIntro">
    <scenery type="boolean">false</scenery>
    <visible type="boolean">false</visible>
    <usedefaultprefix type="boolean">false</usedefaultprefix>
    <descprefix type="string"></descprefix>
    <objectslistprefix type="string"></objectslistprefix>
    <dark type="boolean">false</dark>
    <alias> </alias>
    <object name="player">
      <inherit name="editor_object" />
      <inherit name="editor_player" />
      <alias>player</alias>
      <maxvolume type="int">15</maxvolume>
      <containerfullmessage>You have reach your maxium weight limit. Please drop unneeded items that have a weight to them, to free extra room.</containerfullmessage>
      <skip type="boolean">false</skip>
      <changedname type="script">
        get input {
        }
      </changedname>
    </object>
  </object>
  <command name="Skip">
    <pattern>Skip</pattern>
    <script>
      if (player.skip = False) {
        firsttime {
          player.skip = True
          MoveObject (player, MedicalStation)
        }
        otherwise {
          msg ("You have already passed the skippable dialogue sequence. There is nothing to skip.")
        }
      }
      else {
        msg ("You have already passed the skippable dialogue sequence. There is nothing to skip.")
      }
    </script>
  </command>
  <verb>
    <property>clear</property>
    <pattern>clear</pattern>
    <defaultexpression>"You can't clear " + object.article + "."</defaultexpression>
  </verb>
  <command name="Move">
    <pattern>Move #text#</pattern>
    <script><![CDATA[
      if (text = "debris" or text = "aluminum slab" or text = "aluminum" or text = "slab") {
        if (DebrisSlab.lookedat = True) {
          if (DebrisSlab.moved = False) {
            Bone04.taken = True
            AddToInventory (Bone04)
            RemoveObject (DebrisSlab)
            msg ("<br/>You move the slab of aluminum out of the way, and find a bone fragment was behind it.<br/><br/><i>(Fragment added to inventory)</i><br/>")
            DebrisSlab.moved = True
          }
          else {
            msg ("<br/>Either it is not visible, or it cannot be moved.")
          }
        }
        else {
          msg ("<br/>You need examine (look at) this item before it can be moved.")
        }
      }
      else {
        msg ("<br/>Either it is not visible, or it cannot be moved.")
      }
    ]]></script>
  </command>
  <command name="Clear">
    <pattern>Clear #text#</pattern>
    <script><![CDATA[
      if (text = "debris" or text = "aluminum slab" or text = "aluminum" or text = "slab") {
        if (DebrisSlab.lookedat = True) {
          if (DebrisSlab.moved = False) {
            Bone04.taken = True
            AddToInventory (Bone04)
            RemoveObject (DebrisSlab)
            msg ("<br/>You move the slab of aluminum out of the way, and find a bone fragment was behind it.<br/><br/><i>(Fragment added to inventory)</i><br/>")
            DebrisSlab.moved = True
          }
          else {
            msg ("<br/>Either it is not visible, or it cannot be moved.")
          }
        }
        else {
          msg ("<br/>You need examine (look at) this item before it can be moved.")
        }
      }
      else {
        msg ("<br/>Either it is not visible, or it cannot be moved.")
      }
    ]]></script>
  </command>
  <command name="Read">
    <pattern>Read #text#</pattern>
    <script><![CDATA[
      if (text = "journal" or text = "book" or text = "entry" or text = "journal entry") {
        if (Journal1.alreadyread = True) {
          msg ("<br/>You try to read an entry.<br/><br/>It says,\" Something is trying to break in: Ive got no clue what it is. The door seems sturdy enough, but theres no food or water in here. Im trapped, and the only way out seems to be to sleep through this nightmare. The sign on the wall says stasis, and there are a couple people in these pods. It all seems remarkably straightforward, but I still pray that I am calibrating my pod correctly. I dont want to die.\"")
        }
        else {
          msg ("To read a journal, you need to pick it up.")
        }
      }
      else {
        msg ("You can't read that.")
      }
    ]]></script>
  </command>
  <command name="Call">
    <pattern>Call #text#</pattern>
    <script><![CDATA[
      if (CellPhone.reprogrammed = True) {
        if (text = "Duffy" or text = "duffy" or text = "DUFFY") {
          firsttime {
            msg ("You call Duffy on the cell phone.<br/><br/>Duffy looks at you, shakes his head, then face-palms.")
          }
          otherwise {
            msg ("You call Duffy on the cell phone.<br/><br/>Duffy turns to you and says, \"This is why we can't have nice things.\"")
          }
        }
        else if (text = "Ziggy" or text = "ziggy" or text = "ZIGGY") {
          firsttime {
            msg ("You call Ziggy on the cell phone.<br/><br/>Ziggy looks at you and makes a phone gesture with her hand, as if she is answering it. \"Hey, baby, wassssup!\"")
          }
          otherwise {
            msg ("You call Ziggy on the cell phone.<br/><br/>Ziggy giggles at your sillyness.")
          }
        }
        else {
          msg ("You can't call that.")
        }
      }
      else {
        msg ("You need a phone to call someone.")
      }
    ]]></script>
  </command>
  <verb>
    <property>ask</property>
    <pattern>ask</pattern>
    <defaultexpression>"You can't ask " + object.article + "."</defaultexpression>
  </verb>
  <command name="Riddle Answer">
    <pattern>Answer Riddle #text#</pattern>
    <script><![CDATA[
      if (Got(EightBall)) {
        msg ("You attempt to solve the riddle with the answer, '" + text + "'.")
        if (text = "Octopus" or text = "octopus" or text = "octopi" or text = "OCTOPUS") {
          msg ("A snapping sound can be heard inside the magic 8 ball. The ball begins to shift and an opening appears. A small piece of paper slides from the oriface.<br/><br/><i>(magic 8 ball note has been added to you inventory)</i>")
          AddToInventory (eightballnote)
        }
        else {
          msg ("Nothing happens to the magic 8 ball. Unfortunately, '" + text + "' was the wrong answer.")
        }
      }
      else {
        msg ("To answer the riddle, you need to be carrying the magic 8 ball.")
      }
    ]]></script>
  </command>
  <command name="Riddle Ask">
    <pattern>Ask about riddle</pattern>
    <script><![CDATA[
      if (Got(EightBall)) {
        msg ("A secret slot slides open on the back of the magic 8 ball. A message is shown inside.<br/><br/>\"8 is the magic number...<br/><br/>What dances above the ground, or lies just under the surface<br/>It can fit virtually anywhere it chooses,<br/>And can be any color it chooses at any time?<br/>But despite what its name might imply, it is never sour.<br/>It is smarter than you might think,<br/>And it is always watching, like a fly on the wall.\"<br/><br/>Apparently, the magic 8 ball is expecting you to say some word. Who knows what giving the correct answer will do. The only way to know is to find out.<br/><br/><i>(When you are ready to answer the riddle, type \"Answer Riddle\" followed by you one-word answer.)</i>")
      }
      else {
        msg ("You need to be carrying the magic 8 ball to ask about its riddle.")
      }
    ]]></script>
  </command>
  <command name="Riddle Ask 2">
    <pattern>Ask magic 8 ball about riddle</pattern>
    <script><![CDATA[
      if (Got(EightBall)) {
        msg ("A secret slot slides open on the back of the magic 8 ball. A message is shown inside.<br/><br/>\"8 is the magic number...<br/><br/>What dances above the ground, or lies just under the surface<br/>It can fit virtually anywhere it chooses,<br/>And can be any color it chooses at any time?<br/>But despite what its name might imply, it is never sour.<br/>It is smarter than you might think,<br/>And it is always watching, like a fly on the wall.\"<br/><br/>Apparently, the magic 8 ball is expecting you to say some word. Who knows what giving the correct answer will do. The only way to know is to find out.<br/><br/><i>(When you are ready to answer the riddle, type \"Answer Riddle\" followed by you one-word answer.)</i>")
      }
      else {
        msg ("You need to be carrying the magic 8 ball to ask about its riddle.")
      }
    ]]></script>
  </command>
  <command name="Riddle Ask 3">
    <pattern>Ask magic eight ball about riddle</pattern>
    <script><![CDATA[
      if (Got(EightBall)) {
        msg ("A secret slot slides open on the back of the magic 8 ball. A message is shown inside.<br/><br/>\"8 is the magic number...<br/><br/>What dances above the ground, or lies just under the surface<br/>It can fit virtually anywhere it chooses,<br/>And can be any color it chooses at any time?<br/>But despite what its name might imply, it is never sour.<br/>It is smarter than you might think,<br/>And it is always watching, like a fly on the wall.\"<br/><br/>Apparently, the magic 8 ball is expecting you to say some word. Who knows what giving the correct answer will do. The only way to know is to find out.<br/><br/><i>(When you are ready to answer the riddle, type \"Answer Riddle\" followed by you one-word answer.)</i>")
      }
      else {
        msg ("You need to be carrying the magic 8 ball to ask about its riddle.")
      }
    ]]></script>
  </command>
  <object name="MilitaryMedicalRoom">
    <inherit name="editor_room" />
    <description type="script"><![CDATA[
      ClearScreen
      msg ("<br/>This room appears to have been used for surgery. There are large metal tables and rusted instruments strewn about.")
    ]]></description>
    <alias>surgery room</alias>
    <beforeenter type="script">
      MoveObject (DuffyMain, MilitaryMedicalRoom)
      MoveObject (ZiggyMain, MilitaryMedicalRoom)
    </beforeenter>
    <exit alias="southwest" to="MilitaryBuildingHallway">
      <inherit name="southwestdirection" />
    </exit>
    <object name="MedicalSupplies">
      <inherit name="editor_object" />
      <inherit name="container_open" />
      <inherit name="plural" />
      <alias>pile of medical supplies</alias>
      <isopen />
      <close type="boolean">false</close>
      <open type="boolean">false</open>
      <hidechildren />
      <look>It is a pile of medical supplies.</look>
      <displayverbs type="stringlist">
        <value>Look at</value>
      </displayverbs>
      <object name="stethoscope">
        <inherit name="editor_object" />
        <take />
        <look>It's a stethoscope. You remember one being used by a doctor to listen to your heartbeat.</look>
        <use />
        <selfuseon type="scriptdictionary">
          <item key="audiorecording"><![CDATA[
            msg ("<br/>You place the bell of the stethoscope on the recording device's speaker, and activate it.")
            msg ("<br/>The audio player appears to be repeating a single line in phonetics, \"Lima India Foxtrot Echo Eight Six Zulu Zero Juliet\".")
          ]]></item>
          <item key="bunkeroomceiling"><![CDATA[
            msg ("<br/>You place the bell of stethoscope on the wall. The noises from the creatures on the floor above are magnified. <br/><br/>You can make out several sets of feet sauntering in disorganized directions. It could be a family of racoons - or it could be something else.")
          ]]></item>
        </selfuseon>
      </object>
      <object name="scalpel">
        <inherit name="editor_object" />
        <alias>rusted scalpel</alias>
        <look>A rusty scalpel.</look>
        <take />
      </object>
      <object name="morphine">
        <inherit name="editor_object" />
        <alias>empty vial of morphine</alias>
        <look>It appears to be an empty vial with "Morphine" embossed into the glass.</look>
        <take />
      </object>
      <object name="syringe">
        <inherit name="editor_object" />
        <look>A broken syringe.</look>
        <alias>syringe needle</alias>
        <take />
      </object>
    </object>
    <object name="operatingtables">
      <inherit name="editor_object" />
      <inherit name="namedmale" />
      <look>The operating tables are sturdy, metal beds that have survived for decades with nothing more than rust and staining. </look>
      <alias>operating tables</alias>
      <displayverbs type="stringlist">
        <value>Look at</value>
      </displayverbs>
    </object>
    <object name="bodybags">
      <inherit name="editor_object" />
      <inherit name="namedmale" />
      <alias>thick black bags</alias>
      <displayverbs type="stringlist">
        <value>Look at</value>
      </displayverbs>
      <look type="script"><![CDATA[
        msg ("Thick, black plastic bags are piled in the corner of the room. There are large biohazard symbols painting on the sides.<br/><br/>You assume that over a hundred years time has neutralized the danger.<br/><br/>Many of the bags have holes chewed through them by rodents or other creatures.")
      ]]></look>
      <unzip type="script"><![CDATA[
        firsttime {
          msg ("<br/>You take the zipper on a nearby bag and try to slide it open. The rusted slider snaps off in your hands, allowing you to simple part the two flaps. <br/><br/>Inside the bag is another skeleton. This person's bones are covered in strange nodules and growths. The jaw is wider than normal, with the teeth appear to be missing - replaced by sharp growths from the mandibular bones. The digits on its hands are unusually long and sharp. There is a single bullet hole in the forehead of the skull.")
        }
        otherwise {
          msg ("<br/>You already opended a body bag.<br/><br/>Inside the bag was another skeleton.<br/><br/>This person's bones are covered in strange nodules and growths. The jaw is wider than normal, with the teeth appear to be missing - replaced by sharp growths from the mandibular bones. The digits on its hands are unusually long and sharp. There is a single bullet hole in the forehead of the skull.")
        }
      ]]></unzip>
    </object>
    <object name="skeletonmedicalroom">
      <inherit name="editor_object" />
      <inherit name="namedmale" />
      <alias>skeletal remains</alias>
      <look><![CDATA[Several of the operating tables have bones scattered on them. Most are fragmented, but one skeleton remains intact.<br/><br/>You notice that its bones look ravaged, as if the individual had fought excessively to break from their restaints. Maybe patients had been left behind when this location was abandoned... or overrun.]]></look>
      <displayverbs type="stringlist">
        <value>Look at</value>
      </displayverbs>
    </object>
  </object>
  <object name="MilitaryBriefingRoom">
    <inherit name="editor_room" />
    <alias>briefing room</alias>
    <description type="script"><![CDATA[
      ClearScreen
      msg ("<br/>You are in what appears to be a briefing room. There's an old dry erase board and a large table with decaying leather chairs.")
    ]]></description>
    <beforeenter type="script">
      MoveObject (DuffyMain, MilitaryBriefingRoom)
      MoveObject (ZiggyMain, MilitaryBriefingRoom)
    </beforeenter>
    <exit alias="east" to="MilitaryBuildingHallway">
      <inherit name="eastdirection" />
    </exit>
    <object name="table">
      <inherit name="editor_object" />
      <look><![CDATA[The briefing room table is dry-rotted and leaning like a boat ready to capsize. With part of the underside visible, you notice that there's a note carefully carved deep into the wood under the table top. <br/><br/>It says, "Control Room is easy access. Needs correct tonal playback. Remember: radiation!"]]></look>
      <scenery type="boolean">false</scenery>
    </object>
    <object name="chairs">
      <inherit name="editor_object" />
      <inherit name="plural" />
      <look>The chairs have traces of leather still clinging to the frames, but they look pretty naked now.</look>
      <scenery />
    </object>
    <object name="DryEraseBoard">
      <inherit name="editor_object" />
      <alias>dry erase board</alias>
      <look>The board has a thick layer of mold creeping across the once-white base. It seems to be cracking into several peices as gravity pressures the aging frame.</look>
      <displayverbs type="stringlist">
        <value>Look at</value>
      </displayverbs>
      <alt type="stringlist">
        <value>board</value>
        <value>white board</value>
        <value>dry erase</value>
        <value>chalk board</value>
      </alt>
      <scenery type="boolean">false</scenery>
    </object>
  </object>
  <object name="MilitaryBunkRoom">
    <inherit name="editor_room" />
    <description type="script"><![CDATA[
      ClearScreen
      msg ("<br/>This room appears to have been a dormatory. There are bed frames and lockers. You hear an odd sound coming from the ceiling area.")
    ]]></description>
    <alias>barracks room</alias>
    <beforeenter type="script">
      MoveObject (DuffyMain, MilitaryBunkRoom)
      MoveObject (ZiggyMain, MilitaryBunkRoom)
    </beforeenter>
    <exit alias="west" to="MilitaryBuildingHallway">
      <inherit name="westdirection" />
    </exit>
    <object name="lockbox">
      <inherit name="editor_object" />
      <look>This box is made of thick metal. Way too heavy to carry around. It barely looks worn down after so many years sitting here.</look>
      <takemsg>It's way too heavy to carry.</takemsg>
    </object>
    <object name="pistol">
      <inherit name="editor_object" />
      <take />
    </object>
    <object name="RowOfLockers">
      <inherit name="editor_object" />
      <alias>row of open lockers</alias>
      <displayverbs type="stringlist">
        <value>Look at</value>
      </displayverbs>
      <look>It is a row of rusted lockers. There'ss only one closed locker. The rest were cleared out.</look>
    </object>
    <object name="locker">
      <inherit name="editor_object" />
      <inherit name="container_closed" />
      <inherit name="container_lockable" />
      <isopen />
      <autounlock type="boolean">false</autounlock>
      <autoopen type="boolean">false</autoopen>
      <close type="boolean">false</close>
      <open type="boolean">false</open>
      <look>This locker is the only closed one in the row. It appears to be locked, but the door feels incredibly fragile.</look>
      <opened type="boolean">false</opened>
      <alias>closed locker</alias>
      <displayverbs type="stringlist">
        <value>Look at</value>
      </displayverbs>
      <kick type="script">
        if (locker.opened = False) {
          msg ("You step back and put all the weight of your body behind a kick, center mass into the locker door. The door fractures and bends, before falling to the ground. Inside the locker hangs a hazmat or radiation suit, along with a gieger counter.")
          MoveObject (RadiationSuit, locker)
          MoveObject (GeigerCounter, locker)
          locker.opened = True
        }
        else {
          msg ("You've already opened the it, but you plant another kick into the locker for good measure.")
        }
      </kick>
      <shake type="script">
        if (locker.opened = False) {
          msg ("You shake the locker. It sounds as if peices have broken off, trickling down something soft before hitting the locker floor. Unfortunately, the door is still locked.")
        }
        else {
          msg ("You already opened the locker. But, for some reason, you decide to shake it. Nothing happens.")
        }
      </shake>
    </object>
    <object name="bunkeroomceiling">
      <inherit name="editor_object" />
      <displayverbs type="stringlist">
        <value>Look at</value>
      </displayverbs>
      <look>You hear the pitter-patter of feet through the ceiling above you. The sounds are extremely faint, but something is alive on the second floor.</look>
      <alias>ceiling</alias>
      <visible type="boolean">false</visible>
    </object>
    <object name="beds">
      <inherit name="editor_object" />
      <alt type="stringlist">
        <value>bunks</value>
        <value>bed</value>
        <value>bunk</value>
        <value>bed frames</value>
        <value>frames</value>
        <value>frame</value>
        <value>bed frame</value>
      </alt>
      <look>The bed's matresses are long gone. What's left of them are piles of blackened fuzz, and tattered moldy fabric strewn across the room.</look>
      <scenery />
    </object>
  </object>
  <object name="MilitaryBuildingHallway">
    <inherit name="editor_room" />
    <alias>hallway</alias>
    <description type="script"><![CDATA[
      ClearScreen
      firsttime {
        msg ("<br/>This hallway leads to several areas. The door in the northeast appears to be the only that's locked - sporting a control panel to its side.")
        msg ("<br/>\"I think it's best we all stick together, for safety.\" Duffy says.<br/>")
      }
      otherwise {
        msg ("<br/>This hallway leads to several areas. The door in the northeast appears to be the only that's locked - sporting a control panel to its side.")
      }
    ]]></description>
    <beforeenter type="script">
      MoveObject (DuffyMain, MilitaryBuildingHallway)
      MoveObject (ZiggyMain, MilitaryBuildingHallway)
    </beforeenter>
    <exit alias="south" to="MilitaryComplexLobby">
      <inherit name="southdirection" />
    </exit>
    <exit alias="east" to="MilitaryBunkRoom">
      <inherit name="eastdirection" />
    </exit>
    <exit alias="northeast" to="MilitaryMedicalRoom">
      <inherit name="northeastdirection" />
    </exit>
    <exit alias="west" to="MilitaryBriefingRoom">
      <inherit name="westdirection" />
    </exit>
    <object name="ControlPanelCommandRoom">
      <inherit name="editor_object" />
      <alias>control panel</alias>
      <displayverbs type="stringlist">
        <value>Look at</value>
      </displayverbs>
      <look type="script">
        msg ("The northwest door doesn't have a label, but it is the only door in the hallway with a special locking mechanism. On the mechanism is a single button, and a speaker. The speaker device appears to be if high quality, and seems like it would still work. The device is presumably powered, as a very light static noise is coming from the speaker.")
      </look>
      <pressbutton type="script">
        msg ("You press the button below the speaker. The gentle static noise emanating from the speakers stops for as long as you hold the button. But nothing else appears to be happening.")
      </pressbutton>
    </object>
    <exit name="control room" alias="northwest" to="Control Room">
      <inherit name="northwestdirection" />
      <locked />
      <lockmessage>This door is locked. There is some sort of control panel interface attached to it.</lockmessage>
    </exit>
    <object name="binder">
      <inherit name="editor_object" />
      <inherit name="container_closed" />
      <look>It's a binder designed to store various instruction and safety manuals for, "The Reactor Core". </look>
      <inventoryverbs type="stringlist">
        <value>Look at</value>
        <value>Drop</value>
      </inventoryverbs>
      <displayverbs type="stringlist">
        <value>Look at</value>
        <value>open</value>
      </displayverbs>
      <take type="boolean">false</take>
      <close type="boolean">false</close>
      <hidechildren type="boolean">false</hidechildren>
      <listchildren />
      <onopen type="script">
        msg ("Most of the laminated manual pages have been discarded somewhere. There's one page in the binder.")
      </onopen>
      <object name="RoboticsControlManual">
        <inherit name="editor_object" />
        <alias>Robotics Control Manual</alias>
        <take />
        <inventoryverbs type="stringlist">
          <value>Look at</value>
          <value>Drop</value>
        </inventoryverbs>
        <look><![CDATA[It is a control manual for "Manual Activation Robotic Specialists (MARS)". Much of the page was destroyed or masked with a dark ink. The readable sections say, <br/><br/>"All PERSA reactors have a 'Robotics Room' where Manual Activation Robotic Specialists (MARS) are stored. These tools are critcally useful in the event of a miscommunication in remote instructions to the reactor core. Each MARS can be controlled remotely via a terminal located in a facility control room. Location and security clearance of control rooms vary with each facility."]]></look>
      </object>
    </object>
  </object>
  <object name="MilitaryBuildingAuditorium">
    <inherit name="editor_room" />
    <alias>auditorium</alias>
    <description type="script"><![CDATA[
      ClearScreen
      firsttime {
        msg ("\"I think we're close to that energy source I mentioned,\" Ziggy says.<br/><br/>\"What makes you say that?\" Duffy asks.<br/><br/>\"My scanners - they're freaking out,\" she says, moving the device farther from her face; as if it were not in focus.<br/><br/>\"Your ability to paraphrase those readings is inspiring.\" Duffy smiles, seemingly for the first time.<br/><br/>\"Shoosh,\" she replies.")
        msg ("<br/>You appear to be in an auditorium. The rows of seats are mostly barren, as the fabric has long-since rotted away. Parts of the stage have collapsed. More military gear seems to have been stockpiled in here for easy access. ")
      }
      otherwise {
        msg ("This appears to be an auditorium. The rows of seats are mostly barren, as the fabric has long-since rotted away. Parts of the stage have collapsed. More military gear seems to have been stockpiled in here for easy access. ")
      }
    ]]></description>
    <beforeenter type="script">
      MoveObject (DuffyMain, MilitaryBuildingAuditorium)
      MoveObject (ZiggyMain, MilitaryBuildingAuditorium)
    </beforeenter>
    <exit alias="west" to="MilitaryComplexLobby">
      <inherit name="westdirection" />
    </exit>
    <object name="canister">
      <inherit name="editor_object" />
      <alias>lead canister</alias>
      <visible type="boolean">false</visible>
      <displayverbs type="stringlist">
        <value>Look at</value>
        <value>Take</value>
      </displayverbs>
      <isopen type="boolean">false</isopen>
      <openmsg>You open the lead tube.</openmsg>
      <closemsg>You close the lead tube.</closemsg>
      <opened type="boolean">false</opened>
      <Inside type="boolean">false</Inside>
      <take />
      <takemsg>You take the canister.</takemsg>
      <drop />
      <close type="boolean">false</close>
      <contentsprefix type="string"></contentsprefix>
      <open type="boolean">false</open>
      <inventoryverbs type="stringlist">
        <value>Look at</value>
        <value>Drop</value>
      </inventoryverbs>
      <look type="script"><![CDATA[
        msg ("It's a heavy lead canister. There is a yellow symbol on the side, which seems to bring back a memory - a single word; \"Radioactive\".")
        if (canister.inside = "True") {
          msg ("<br/>You've already opened the tube and discovered a small sample of radioactive material.")
        }
      ]]></look>
      <opencap type="script">
        if (Got(canister)) {
          msg ("You unscrew the cap on the canister. Inside, you see a small and dull piece of metal. Probably radioactive.")
          canister.opened = True
          canister.inside = True
        }
        else {
          msg ("You must be carrying the container to open it.")
        }
      </opencap>
      <closecap type="script">
        if (Got(canister)) {
          msg ("You screw the cap back onto the canister.")
          canister.opened = False
        }
        else {
          msg ("You must be carrying the container to close it.")
        }
      </closecap>
    </object>
    <object name="seating">
      <inherit name="editor_object" />
      <inherit name="namedmale" />
      <displayverbs type="stringlist">
        <value>Look at</value>
      </displayverbs>
      <look>The seating mostly consists of bare metal frames, folded up. Cushioning was the first to go in the sweltering and humid air that seems to gather and stagnate here. They don't look comfortable at all.</look>
    </object>
    <object name="stage">
      <inherit name="editor_object" />
      <displayverbs type="stringlist">
        <value>Look at</value>
      </displayverbs>
      <look type="script"><![CDATA[
        msg ("The back of the stage has partially collapsed, but the front is cleared.<br/><br/>You notice a small metal tube sitting near the front of the stage. It doesn't seem to be part of the surrounding mess.")
        MakeObjectVisible (canister)
      ]]></look>
    </object>
    <object name="militarystockpile">
      <inherit name="editor_object" />
      <alias>military stockpile</alias>
      <displayverbs type="stringlist">
        <value>Look at</value>
      </displayverbs>
      <look>This stockpile contains more ammunition, preserved ration bars, and various eqiupment that you don't recognize.</look>
    </object>
    <object name="large hole">
      <inherit name="editor_object" />
      <look type="string"></look>
      <displayverbs type="stringlist">
        <value>Look at</value>
      </displayverbs>
      <climbdowninto type="script"><![CDATA[
        if (RadiationSuit.worn = True) {
          msg ("<br/>\"We can't follow you down there, human,\" Duffy says. \"So be careful.\"")
          wait {
            MoveObject (player, UndergroundRoom1)
          }
        }
        else {
          msg ("\"Stop.\" Duffy says. I am detecting high levels of radiation inside this collapsed area. If we're going down there, we need some protection. And we didn't bring anything with us that would do the job. <br/> <br/>'Okay,' you think. 'There'll be another way.'")
        }
      ]]></climbdowninto>
    </object>
  </object>
  <object name="MilitaryBunker">
    <inherit name="editor_room" />
    <alias>military bunker</alias>
    <beforeenter type="script">
      MoveObject (DuffyMain, MilitaryComplexLobby)
      MoveObject (ZiggyMain, MilitaryComplexLobby)
    </beforeenter>
    <description type="script">
      ClearScreen
    </description>
    <exit alias="southwest" to="MilitaryComplexLobby">
      <inherit name="southwestdirection" />
    </exit>
  </object>
  <verb>
    <property>unzip</property>
    <pattern>unzip</pattern>
    <defaultexpression>"You can't unzip " + object.article + "."</defaultexpression>
  </verb>
  <object name="Control Room">
    <inherit name="editor_room" />
    <description type="string"></description>
    <beforeenter type="script">
      MoveObject (DuffyMain, Control Room)
      MoveObject (ZiggyMain, Control Room)
    </beforeenter>
    <exit alias="southeast" to="MilitaryBuildingHallway">
      <inherit name="southeastdirection" />
    </exit>
    <object name="audiorecording">
      <inherit name="editor_object" />
      <displayverbs type="stringlist">
        <value>Look at</value>
      </displayverbs>
      <look type="script">
        msg ("It appears to be an audio recording device. A message appears to have been taped to the device. Because the room was sealed, it didn't decay as quickly. However, the words are illegible.")
      </look>
      <turnon type="script">
        msg ("You turn on the audio device, which is still plugged into the wall. It begins hissing a barely audible series of noises. You can almost make out words being stated through the dying speakers, but they are too soft to make out what it is saying.")
      </turnon>
      <alias>audio recording</alias>
    </object>
    <object name="robotcomputer">
      <inherit name="editor_object" />
      <displayverbs type="stringlist">
        <value>Look at</value>
      </displayverbs>
      <access type="boolean">false</access>
      <alias>computer terminal</alias>
      <look type="script">
        if (robotcomputer.access = True) {
          msg ("It's a control center for robotic drones in the reactor room. You've logged in correctly, now you simply need to enter the correct command.")
        }
        else {
          msg ("It is a computer interface labeled, 'Indirect Reactor Control'. The monitor is requesting a password.")
        }
      </look>
      <activate type="script"><![CDATA[
        if (robotcomputer.access = False) {
          msg ("<br/>The computer requests a password.<br/><br/><i>(Enter the password now)</i>")
          get input {
            if (result = "LIFE86Z0J" or result = "life86z0j") {
              msg ("<br/>The computer accepts your password, and boots to a control panel. The control panel describes the core functionality. <br/><br/>Apparently, this computer activates and controls robotic maitenance drones. These drones negate the dangerous nature of working in a radioactive environment, and allow the user to interface with the reactor in a manual way, while still being in a remote location. There is a warning displayed at the bottom of the screen. It says,<br/><br/>\"Per AOSA guidlines, section 3.34 - in the event of a breakdown in direct remote communication with the reactor, certified engineers may use robotics to manually interface with the reactor.\"")
              robotcomputer.access = True
              msg ("<br/>A command line is displayed on the console. It says, \"Type 'Activate MARS' to begin.\"")
            }
            else {
              msg ("<br/>The computer rejects your password, and refreshes the screen.<br/><br/><i>(Press \"Activate\" on the computer terminal to try another password)</i>")
            }
          }
        }
        else if (robotcomputer.access = True) {
          msg ("<br/>The computer boots to a control panel. The control panel describes the core functionality. <br/><br/>Apparently, this computer activates and controls robotic maitenance drones. These drones negate the dangerous nature of working in a radioactive environment, and allow the user to interface with the reactor in a manual way, while still being in a remote location. There is a warning displayed at the bottom of the screen. It says,<br/><br/>\"Per AOSA guidlines, section 3.34 - in the event of a breakdown in direct remote communication with the reactor, certified engineers may use robotics to manually interface with the reactor.\"")
          msg ("<br/>A command line is displayed on the console. It says, \"Type 'Activate MARS' to begin.\"")
        }
      ]]></activate>
    </object>
  </object>
  <verb>
    <property>kick</property>
    <pattern>kick</pattern>
    <defaultexpression>"You can't kick " + object.article + "."</defaultexpression>
  </verb>
  <verb>
    <property>shake</property>
    <pattern>shake</pattern>
    <defaultexpression>"You can't shake " + object.article + "."</defaultexpression>
  </verb>
  <verb>
    <property>climbdowninto</property>
    <pattern>climb down into</pattern>
    <defaultexpression>"You can't climb down into " + object.article + "."</defaultexpression>
  </verb>
  <verb>
    <property>takeoff</property>
    <pattern>take off</pattern>
    <defaultexpression>"You can't take off " + object.article + "."</defaultexpression>
  </verb>
  <object name="UndergroundRoom1">
    <inherit name="editor_room" />
    <description><![CDATA[<br/>You're at the base of the hole, in a dimly-lit room. The dust down here is incredibly thick. You can make out a glowing map framed on the wall. <br/><br/>There's a door to the east, almost engulfed by concrete debris. The door to the north is open.]]></description>
    <alias>bunker room</alias>
    <object name="Map">
      <inherit name="editor_object" />
      <alias>framed map</alias>
      <displayverbs type="stringlist">
        <value>Look at</value>
      </displayverbs>
      <look type="script">
        msg ("It's a map of the reactor core level.")
        picture ("ReactorCoreMap.JPG")
      </look>
    </object>
    <object name="ceilinghole">
      <inherit name="editor_object" />
      <alias>ceiling hole</alias>
      <displayverbs type="stringlist">
        <value>Look at</value>
      </displayverbs>
      <look>It's the hole that you climbed down through.</look>
      <climbupthrough type="script">
        MoveObject (player, MilitaryBuildingAuditorium)
      </climbupthrough>
    </object>
    <exit alias="north" to="UndergroundRoom2">
      <inherit name="northdirection" />
    </exit>
  </object>
  <object name="UndergroundRoom2">
    <inherit name="editor_room" />
    <description><![CDATA[You are in a room with a large reinforced window overlooking the reactor core proper. <br/><br/>The door to the north bulges, and part of the wall next to it has collapsed. A large amount of debris must have settled in the next room. There is no way to get to the reactor core from here.]]></description>
    <alias>overlook</alias>
    <exit alias="south" to="UndergroundRoom1">
      <inherit name="southdirection" />
    </exit>
    <object name="window">
      <inherit name="editor_object" />
      <look><![CDATA[This window is made of incredibly thick, reinforced glass. It overlooks the reactor. <br/><br/>You see the core pulsing with life. The entire structure glows light blue periodically as energy ebbs and flows through the peripheral reactor attachments.]]></look>
    </object>
  </object>
  <verb>
    <property>opencap</property>
    <pattern>open cap</pattern>
    <defaultexpression>"You can't open cap " + object.article + "."</defaultexpression>
  </verb>
  <verb>
    <property>closecap</property>
    <pattern>close cap</pattern>
    <defaultexpression>"You can't close cap " + object.article + "."</defaultexpression>
  </verb>
  <verb>
    <property>enterpassword</property>
    <pattern>enter password</pattern>
    <defaultexpression>"You can't enter password " + object.article + "."</defaultexpression>
  </verb>
  <object name="RoboticsRoom">
    <inherit name="editor_room" />
    <description type="script"><![CDATA[
      ClearScreen
      msg ("<br/>You are in control of a robot near the reactor core. A sign on the wall reads, \"Manual Activation Robotic Specialists (MARS) - Robotics Control\".")
    ]]></description>
    <alias>Robotics Control</alias>
    <object name="MARS 01">
      <inherit name="editor_object" />
      <look>It's another, inactive robot. An identification tag reads, "MARS 01".</look>
    </object>
    <object name="RCSR 02">
      <inherit name="editor_object" />
      <look type="string"></look>
      <alias>MARS 02</alias>
    </object>
    <object name="MARS 03">
      <inherit name="editor_object" />
      <look>It's another, inactive robot. An identification tag reads, "MARS 03".</look>
    </object>
    <exit alias="north" to="CorePrepRoom">
      <inherit name="northdirection" />
    </exit>
    <object name="audiocouplings">
      <inherit name="editor_object" />
      <visible type="boolean">false</visible>
      <scenery />
      <look>There are intact audio couplings on MARS 01. It looks like an easy swap for your bot's broken audio couplings.</look>
      <alias>audio couplings</alias>
      <alt type="stringlist">
        <value>audio</value>
        <value>couplings</value>
        <value>audio device</value>
        <value>audio coupling</value>
        <value>coupling</value>
      </alt>
      <take />
      <ontake type="script">
        msg ("You instruct the robot to take and replace its audio coupling. Instantly, the diagnostics read a successful connection, and you hear the deep buzzing noise coming from the reactor core nearby.")
        survivorrecording.fixed = True
        RemoveObject (audiocouplings)
      </ontake>
      <takemsg>You take the functioning audio couplings from MARS 01.</takemsg>
      <drop type="boolean">false</drop>
    </object>
  </object>
  <verb>
    <property>pressbutton</property>
    <pattern>press button</pattern>
    <defaultexpression>"You can't press button " + object.article + "."</defaultexpression>
  </verb>
  <verb>
    <property>climbupthrough</property>
    <pattern>climb up through</pattern>
    <defaultexpression>"You can't climb up through " + object.article + "."</defaultexpression>
  </verb>
  <command name="Robotics Comp">
    <pattern>Activate MARS</pattern>
    <script><![CDATA[
      if (robotcomputer.access = True) {
        if (game.pov.parent = Control Room) {
          msg ("<br/>You activate a robot via the control computer. A camera flickers on, somewhere in the depths of the facility.<br/><br/>Diagnostic information flashes across the screen,<br/>\"Control: Success<br/> Audio: Failure<br/> Movement: Success<br/> Status: Ready\"<br/><br/> You are in control of this small, six-wheeled robot. The controls seem relaitvely simple.")
          ChangePOV (RCSR 02)
          msg ("<br/><i>(You are now in control of a robot near the reactor core. Use this robot to cause a reset of the reactor core. The player's point of view has been moved to the robot, so you ARE the robot for now.)</i>")
        }
        else {
          msg ("This command is not currently active.")
        }
      }
      else {
        msg ("This command is not currently active.")
      }
    ]]></script>
  </command>
  <object name="CorePrepRoom">
    <inherit name="editor_room" />
    <description type="script"><![CDATA[
      ClearScreen
      msg ("<br/>You are in a preperation room for entering the React Core Room.<br/><br/>The sterilizing effect of heavy radiation, and the fact that this area is sealed off from the atmosphere has kept everything in pristine condition.        ")
    ]]></description>
    <alias>Core Prep room</alias>
    <exit alias="south" to="RoboticsRoom">
      <inherit name="southdirection" />
    </exit>
    <exit alias="east" to="ReactorCoreRoom">
      <inherit name="eastdirection" />
    </exit>
    <object name="survivorrecording">
      <inherit name="editor_object" />
      <fixed type="boolean">false</fixed>
      <displayverbs type="stringlist">
        <value>Look at</value>
      </displayverbs>
      <look type="script">
        msg ("It's an audio recording device, ready for playback")
      </look>
      <turnon type="script"><![CDATA[
        if (survivorrecording.fixed = True) {
          msg ("A message plays, <br/><br/>\"Sergeant Mason Jin, here. I got caught behind in the lockdown. The facility was overrun in a matter of seconds. I saw Wyle, Chavez, Martin, and Raz all die. The Metas came in through the roof, and poured down on top of us. Damn they're still smart. Command was wrong. <br/><br/>In the chaos, something big tore a hole down through the bunker via the auditorium. That got me down here to the reactor. I put on a suit, but that'll be useful til' I need to take a wiz - or eat. I see the creatures through the window. They're in the observation deck. I hope that glass holds them.<br/><br/><i> sigh </i><br/><br/>I'm afraid... because I know there's no way out. They probably can't get to me here, but... here is where'll I'll stay. <br/><br/>This is all thanks to Ashland Nanotech. I hope the weight of 7 billion lives bears down on their conscious' til' the moment they die. <i>(The man breaths heavily for a few moments, before continuing)</i><br/><br/>It's tough... because you can't fight these things like a human. You don't engage The Metas, worried that you'll die. You worry that you'll survive. Because if you do, you might live long enough to become one.<br/><br/>But... <i>(There is a long silence) </i> I won't let that happen. <i> You hear the sound of a gun cocking in the audio recording </i>\"<br/><br/>The recording stops there.")
        }
        else {
          msg ("<br/>You can't hear a word. <br/><br/>The diagnostics mentioned an audio error in this robot. An error message on the control console flashes, saying, \"Audio couplings inoperable.\" <br/><br/>Maybe there's a way to fix it.")
        }
      ]]></turnon>
      <alias>recording</alias>
    </object>
    <object name="TextOnWalls">
      <inherit name="editor_object" />
      <look><![CDATA[There are various words scribbled on the wall in this room. <br/><br/>"They've won. A war of attrition. And they won." <br/><br/>"Metamorphs!" <br/><br/>"They can't take you if you're dead." <br/><br/>"Death is the only way out." <br/><br/>"Burn in hell Ashland Nanotech." ]]></look>
      <alias>message scribbled on wall</alias>
      <displayverbs type="stringlist">
        <value>Look at</value>
      </displayverbs>
    </object>
    <object name="RadiationSuitBody">
      <inherit name="editor_object" />
      <alias>body in radiation suit</alias>
      <look><![CDATA[The body is perfectly preserved, other than its total dessication. Essentially, it is a mummy. <br/><br/>There's a hole on both sides of the temple of the radiation suit's mask. A gun still rests, firmly grasped in the right hand.]]></look>
      <displayverbs type="stringlist">
        <value>Look at</value>
      </displayverbs>
    </object>
    <object name="coreroomgun">
      <inherit name="editor_object" />
      <look>That pistol appears like new.</look>
      <visible type="boolean">false</visible>
      <scenery />
      <takemsg>That pistol is highly radioactive. Also, this MARS robot does not have an inventory.</takemsg>
    </object>
  </object>
  <object name="ReactorCoreRoom">
    <inherit name="editor_room" />
    <description type="script"><![CDATA[
      ClearScreen
      msg ("<br/>This is it... the Reactor Control Room. Resetting the reactor would reset security overrides, and open the bunker doors.<br/><br/>The energy leaking from the core is almost blinding; even viewing it through a small camera on the MARS.")
    ]]></description>
    <alias>Reactor Core Room</alias>
    <object name="ReactorCoreActual">
      <inherit name="editor_object" />
      <alias>Reactor Core</alias>
      <look>It's the reactor. The core is obviously functioning at a high capacity. This must be where all power is originating; even for the bed of live wires around that massive skeleton.</look>
      <attemptreset type="script"><![CDATA[
        msg ("<br/>This puzzle is not currently working. You have reached the end of the demo. Thanks for playing!<br/>")
        picture ("Rod Alignment 1.PNG")
      ]]></attemptreset>
      <displayverbs type="stringlist">
        <value>Look at</value>
      </displayverbs>
    </object>
    <exit alias="west" to="CorePrepRoom">
      <inherit name="westdirection" />
    </exit>
  </object>
  <verb>
    <property>attemptreset</property>
    <pattern>attempt reset</pattern>
    <defaultexpression>"You can't attempt reset " + object.article + "."</defaultexpression>
  </verb>
  <verb>
    <property>play</property>
    <pattern>play</pattern>
    <defaultexpression>"You can't play " + object.article + "."</defaultexpression>
  </verb>
</asl>