<!--Saved by Quest 5.3.4762.29157-->
<asl version="530">
  <include ref="English.aslx" />
  <include ref="Core.aslx" />
  <game name="tests">
    <gameid>2d119994-3ea2-42e3-908d-56b99bdbcc2c</gameid>
    <version>1.0</version>
    <firstpublished>2013</firstpublished>
  </game>
  <object name="room">
    <inherit name="editor_room" />
    <object name="player">
      <inherit name="editor_object" />
      <inherit name="editor_player" />
      <money type="int">0</money>
      <statusattributes type="stringdictionary">money = </statusattributes>
    </object>
    <object name="gap 1">
      <inherit name="editor_object" />
      <inherit name="container_limited" />
      <open type="boolean">false</open>
      <isopen type="boolean">false</isopen>
    </object>
    <object name="book">
      <inherit name="editor_object" />
      <inherit name="container_open" />
      <alias>Book</alias>
      <take />
      <open type="boolean">false</open>
      <close type="boolean">false</close>
      <put>work!!!</put>
    </object>
    <exit name="door" alias="south" to="room2">
      <inherit name="southdirection" />
      <locked />
    </exit>
    <object name="money">
      <inherit name="editor_object" />
      <take />
      <takemsg>You took the money.</takemsg>
      <ontake type="script">
        player.money = player.money+50
      </ontake>
    </object>
  </object>
  <object name="room2">
    <inherit name="editor_room" />
    <exit alias="north" to="room">
      <inherit name="northdirection" />
    </exit>
  </object>
  <verb>
    <property>add</property>
    <pattern>add</pattern>
    <defaultexpression>"You can't add " + object.article + "."</defaultexpression>
  </verb>
  <verb>
    <property>remove</property>
    <pattern>remove</pattern>
    <defaultexpression>"You can't remove " + object.article + "."</defaultexpression>
  </verb>
  <verb>
    <property>steal</property>
    <pattern>steal</pattern>
    <defaultexpression>"You can't steal " + object.article + "."</defaultexpression>
  </verb>
  <verb>
    <property>put</property>
    <defaultexpression>"You can't put " + object.article + "."</defaultexpression>
    <pattern type="string"><![CDATA[^put (?<object>.*) (on|in) (?<object2>.*)$|^put (?<object>.*)$]]></pattern>
  </verb>
</asl>