<!--Saved by Quest 5.6.5783.24153-->
<asl version="550">
  <include ref="English.aslx" />
  <include ref="Core.aslx" />
  <game name="Title Test">
    <gameid>7ceddfee-9d30-4032-8a24-5a73410758e0</gameid>
    <version>1.0</version>
    <firstpublished>2016</firstpublished>
    <css><![CDATA[<style type="text/css">div#txtCommandDiv {border:none; font-size:12pt; font-family:Georgia, serif; } input#txtCommand { outline:none; border:none; font-size:16px; margin:0; padding:0; }</style>
   
       <style type="text/css">
                 
        div#txtCommandDiv {
            border: none;
            background: no-repeat;
          }
          input#txtCommand {
            outline:none;
            border: none;
            margin:0;
            padding:0;
            max-width: 1000px;
          }
          #status { display: none !important; visibility: hidden !important; }       
          </style>
                            ]]></css>
    <showscore />
    <showhealth />
    <feature_asktell />
    <defaultfontsize type="int">17</defaultfontsize>
    <underlinehyperlinks type="boolean">false</underlinehyperlinks>
    <setcustompadding />
    <custompaddingbottom type="int">100</custompaddingbottom>
    <defaultwebfont>Amarante</defaultwebfont>
    <defaultbackground>Black</defaultbackground>
    <setcustomwidth />
    <defaultforeground>DarkGreen</defaultforeground>
    <custompaddingleft type="int">50</custompaddingleft>
    <custompaddingright type="int">50</custompaddingright>
    <showborder type="boolean">false</showborder>
    <enablehyperlinks type="boolean">false</enablehyperlinks>
    <backgroundimage>black background.jpg</backgroundimage>
    <setbackgroundopacity type="boolean">false</setbackgroundopacity>
    <backgroundopacity type="double">0</backgroundopacity>
    <showpanes />
    <showlocation type="boolean">false</showlocation>
    <customwidth type="int">1300</customwidth>
    <showtitle type="boolean">false</showtitle>
    <attr name="autodescription_youarein" type="int">0</attr>
    <custompaddingtop type="int">50</custompaddingtop>
    <attr name="autodescription_description" type="int">1</attr>
    <attr name="autodescription_youcansee" type="int">0</attr>
    <pov type="object">Xanadu</pov>
    <start type="script">
      JS.eval ("getCSSRule('a.cmdlink').style.color='#000000'")
      JS.setCommandBarStyle (GetCurrentTextFormat("") + ";border:" + game.defaultbackground)
    </start>
    <onhealthzero type="script">
      msg ("You have had the life sucked out of you.  Good luck in your next life...")
    </onhealthzero>
    <statusattributes type="stringdictionary">
      <item>
        <key>percent</key>
        <value><![CDATA[<div style="width:100%; height:24px; border:1px solid blue;"><div style="background-color:blue;width:!%;height:100%"></div></div><div style="text-align:center">!%</div>]]></value>
      </item>
    </statusattributes>
    <percent type="int">0</percent>
  </game>
  <object name="Title Room">
    <inherit name="editor_room" />
    <usedefaultprefix type="boolean">false</usedefaultprefix>
    <firstenter type="script">
    </firstenter>
    <beforefirstenter type="script">
    </beforefirstenter>
    <enter type="script"><![CDATA[
      SetFontSize (40)
      SetTimeout (5) {
        picture ("Xanadu 4 gif.gif")
        SetTimeout (10) {
          ClearScreen
          msg ("It all started innocently enough...")
        }
        SetTimeout (15) {
          ClearScreen
          msg ("...you went with Straussberger, a friend and American military hero, to search an abandoned terrorist compound for clues.")
        }
        SetTimeout (24) {
          ClearScreen
          msg ("You arrived on location.<br/><br/>But... you were attacked before you arrived at the compound.")
        }
        SetTimeout (32) {
          ClearScreen
          msg ("Your car exploded.  You awoke on a cliff's edge, left for dead.  Alone...")
        }
        SetTimeout (40) {
          ClearScreen
          msg ("Somehow you survived and managed to defend your life against the pursuing Dingo henchmen and get into the compound safely.")
        }
        SetTimeout (50) {
          ClearScreen
          msg ("You thought you were safe, but when you arrived at the compound you found it occupied.  You were captured by Dr. Dingo - who turned out being your old friend.  <br/><br/>Or so you thought...")
        }
        SetTimeout (61) {
          ClearScreen
          msg ("You escaped your cell and met a creature named Blerk who became your only trusted companion.")
        }
        SetTimeout (68) {
          ClearScreen
          msg ("The two of you discovered that Dr. Dingo had an imposter that presented himself as your friend, Straussberger.  It was time to discover who the real Dr. Dingo was.")
        }
        SetTimeout (77) {
          ClearScreen
          msg ("In your adventure, you and Blerk traversed the compound overcoming seemingly insurmountable obstacles.  Finally, you discovered the real Dr. Dingo.")
        }
        SetTimeout (86) {
          ClearScreen
          msg ("To your surprise, you found the real Dr. Dingo was actually a female.  An alluring woman.  Beautiful.  Red hair.  Shapely.  Dangerous.<br/>")
          SetTimeout (7) {
            msg ("<br/>Despite her beauty, it was dangerous.  You had to leave.")
          }
        }
        SetTimeout (97) {
          ClearScreen
          msg ("Against all odds... <br/>")
          SetTimeout (3) {
            msg ("You found the real Straussberger.  You befriended Blerk.  You made plans for the three of you to escape.")
          }
        }
        SetTimeout (108) {
          ClearScreen
          msg ("After escaping, you collapsed.... fatigued in the hot desert.")
        }
        SetTimeout (114) {
          ClearScreen
          msg ("You wake up...")
        }
        SetTimeout (119) {
          ClearScreen
          msg ("...in a strange hut in an unknown village.  A lady is asking you questions about who you are, why you are here, and why dangerous looking people have come looking for you.")
        }
        SetTimeout (129) {
          ClearScreen
          msg ("But... you remember nothing...<br/>")
        }
        SetTimeout (134) {
          ClearScreen
          msg ("Your adventure begins.")
          SetFontSize (17)
        }
        SetTimeout (137) {
          msg ("<br/><br/><br/><br/><font color = \"green\">Please press any key to continue.")
          wait {
            stop sound
            MoveObject (Xanadu, hut)
          }
        }
      }
      play sound ("Club Diver.mp3", false, false)
    ]]></enter>
    <beforeenter type="script">
      HideCommandBar
    </beforeenter>
    <object name="Xanadu">
      <inherit name="editor_object" />
      <inherit name="editor_player" />
      <takemsg>How about you try and take yourself and see how that works out for you.</takemsg>
      <drop type="boolean">false</drop>
      <dropmsg>As much as you might like to drop yourself off and forget about yourself forever, you cannot.</dropmsg>
      <alt type="stringlist">
        <value>me</value>
      </alt>
      <look type="script">
        if (GetBoolean(Xanadu, "quenched")) {
          msg ("You are looking like you, just dirtier and a little rougher around the edges.  Your head has cleared a bit, but you still don't recall much of anything other than your name.")
        }
        else {
          msg ("You look terrible.  Your head hurts.  You are very hungry and your throat is raw.  You've seen better days.")
        }
      </look>
      <maxscore type="int">100</maxscore>
      <score type="int">0</score>
      <changedscore type="script">
        game.percent = Xanadu.score*100 / Xanadu.maxscore
        msg ("Your percent is now " + game.percent)
      </changedscore>
    </object>
  </object>
  <object name="hut">
    <inherit name="editor_room" />
    <alias><![CDATA[<b><u>Inside a hut</b></u>]]></alias>
    <usedefaultprefix type="boolean">false</usedefaultprefix>
    <description type="script"><![CDATA[
      if (GetBoolean(hut, "observed")) {
        msg ("You are inside a crudely-made hut.  <br/><br/>A few young children continue to run in and out of the hut playing some sort of game.  Calista is tending to the chickens.")
      }
      else {
        msg ("You are inside a crudely-made hut.<br/><br/>Children are scurrying around, running into and out of the hut, shrieking with delight as they do so.  Despite their joy, they are giving you quite a headache.  There is a large, colorfully dressed woman working on the other side of the hut.  Her back is turned toward you, but she occassionally glances over her shoulder at you and offers a smile.")
      }
    ]]></description>
    <enter type="script">
      ClearScreen
      ShowCommandBar
    </enter>
    <beforeenter type="script">
      SetFontName ("'Courier New', Courier, monospace")
    </beforeenter>
    <object name="woman">
      <inherit name="editor_object" />
      <alt type="stringlist">
        <value>lady</value>
        <value>gal</value>
        <value>girl</value>
      </alt>
      <takemsg>She appears heavy.  She also would probably not enjoy being part of your inventory.  You leave her alone.</takemsg>
      <drop />
      <look type="script">
        if (GetBoolean(woman, "observed")) {
          msg ("Calista is wearing a colorful robe and is currently tending to the chickens.  Occassionally, she'll turn in your direction, smile, and nod.")
        }
        else {
          msg ("She is colorfully dressed in a long silky robe.  Currently, she facing away from you, busy working on something.  You can't tell what she is doing because she makes a better door than a window.  She is quiet but not eerily so.  From her occassional smile, she seems glad you are here.")
        }
      </look>
      <speak type="script"><![CDATA[
        firsttime {
          if (GetBoolean(Xanadu, "quenched")) {
            msg ("\"Did you enjoy your drink, sir?\" she asks while smiling at you.  \"Those there drinks will make you feel better.\"")
          }
          else {
            msg ("\"Well, 'ello dearie,\" she says in a thick, pleasant accent.  \"My name is Calista.  How are you feeling?  Is there something that you need?\"  She smiles.<br/><br/>Come to think of it, you are pretty thirsty.")
            MakeObjectVisible (Calista)
            MakeObjectInvisible (woman)
          }
        }
        otherwise {
          if (GetBoolean(Xanadu, "quenched")) {
            msg ("\"Did you enjoy your drink, sir?\" she asks while smiling at you.  \"Those there drinks will make you feel better.\"")
          }
          else {
            msg ("She listens and her countenance suggests that she feels pity for you.  \"You do not look so good, sir.  Would like something to drink?  You should really get a drink.  I would be happy to make you one.\"  She smiles at you and adds, \"Just let me know, sir.")
          }
        }
      ]]></speak>
      <watch type="script">
        if (GetBoolean(woman, "observed")) {
          msg ("So far you've seen her slit the throats of a few chickens, pluck them, and hang them on the line.")
        }
        else {
          msg ("You cringe as you see the woman slit the throat of a live chicken.  She hangs it on a thin rope with a few other featherless birds.  She moves down the line to another headless chicken and begins plucking.  She must be getting ready for a meal.")
          SetObjectFlagOn (woman, "observed")
        }
      </watch>
      <observe type="script">
        if (GetBoolean(woman, "observed")) {
          msg ("So far you've seen her slit the throats of a few chickens, pluck them, and hang them on the line.")
        }
        else {
          msg ("You cringe as you see the woman slit the throat of a live chicken.  She hangs it on a thin rope with a few other featherless birds.  She moves down the line to another headless chicken and begins plucking.  She must be getting ready for a meal.")
          SetObjectFlagOn (woman, "observed")
        }
      </observe>
      <ask type="scriptdictionary">
        <item key="drink water beverage thirst "><![CDATA[
          if (GetBoolean(Xanadu, "quenched")) {
            msg ("\"Ah.  You like, yes?\"  Calista smiles.  \"But, you should not drink another, sir.  Too many will make you sick.\"")
          }
          else {
            msg ("\"Yes, right away, good sir.\"  <br/><br/>Calista exits the hut and within a few moments she returns with a brown cup.  She walks over to the chickens and grabs a few items, grinds them up and sprinkles them in the cup.  She walks towards you and shoves the big drink into your hands.  \"Drink up, sir,\" she says with a smile.")
            AddToInventory (drink1)
            MakeObjectVisible (drink1)
          }
        ]]></item>
        <item key="kids children kid child boys girls boy girl">
          if (GetBoolean(Xanadu, "quenched")) {
            msg ("\"Ah, you know.  Kids will be kids.  Chasing, playing.  They are having fun, yes.\"  Calista smiles and returns to her work.")
          }
          else {
            msg ("You begin to speak but your throat is raw.  It feels like you have been eating a diet rich in sand.  Calista notices your efforts and says, \"Do you need a drink, sir.  I'll be glad to get you one.  Just ask.\"  She smiles and continues working.")
          }
        </item>
      </ask>
    </object>
    <object name="children">
      <inherit name="editor_object" />
      <usedefaultprefix type="boolean">false</usedefaultprefix>
      <alt type="stringlist">
        <value>kids</value>
        <value>child</value>
        <value>kid</value>
      </alt>
      <takemsg>Are you some sort of sick pedophile??  Creep.  Let the kids play their game and leave them alone.</takemsg>
      <look type="script">
        if (GetBoolean(Xanadu, "quenched")) {
          msg ("The children are young - you'd say ranging from five to ten years of age.  They are playing some sort of game that you sort of understand as hide-and-seek they are speaking a language that you do not understand.  They are loud, but seem to be having a good time.")
        }
        else {
          msg ("The children are young, loud and obnoxious.  They are playing some sort of game where evidently 'loudness' is an advantageous quality.  Your head is throbbing and you wish they would just shut up so you could think.")
        }
      </look>
      <speak type="script"><![CDATA[
        if (GetBoolean(Xanadu, "quenched")) {
          msg ("The child regards you when you speak by putting one finger up near their lips and offering the universal 'shush' command.  Evidently, you are disturbing their game.  <br/><br/>The kid notices your expression, quietly shuffles over to you, bops you on the nose with his thumb and whispers, <b>\"Geseende\"</b> in your ear.")
        }
        else {
          msg ("You don't feel like talking right now, especially to a bunch of kids who are loud and obnoxious.  Your throat feels as if you have been swallowing glass.  You better quench that thirst before doing anything else.")
        }
      ]]></speak>
      <askdefault type="script">
        if (GetBoolean(Xanadu, "quenched")) {
          msg ("The children try to ignore your questions and plead quietly with you to remain quiet so you do not give away their location.  Must be part of the game...")
        }
        else {
          msg ("The sound of your own voice above the din just adds to your headache.  You should get hydrated and perhaps the screaming demons in your head will go away.")
        }
      </askdefault>
      <telldefault type="script">
        if (GetBoolean(Xanadu, "quenched")) {
          msg ("The children try to ignore your riveting comments and wave their hands in your direction in a gesture for you to stay quiet and not ruin their game...")
        }
        else {
          msg ("Your voice comes out gravely and manly - definitely not like your own.  Before yapping up a storm, perhaps you should quench your thirst?")
        }
      </telldefault>
      <watch type="script"><![CDATA[
        if (GetBoolean(Xanadu, "quenched")) {
          msg ("With a little settling of your stomach and clearing of the cobwebs, you watch the children play their game.  A few kids run in, sometimes one, sometimes two or three.  Shortly thereafter another kid enters and tries to tag one of the others.  But, the kid doesn't tag normally, but instead raises one hand up with two outstretched, curved fingers and pokes them down on one of the other kids.  Occassionally, before a kid gets poked, they will shout <b>\"Akhet! Akhet!\"</b> at which point the \"tagger\" races from the hut screaming while the other children laugh and follow.")
          SetObjectFlagOn (game1, "watched")
        }
        else if (GetBoolean(game1, "watched")) {
          msg ("The kids are still running around playing a game.  It's all nice and quiet until one kids shouts <b>\"Akhet!\"</b> just before getting tagged.  Then they all run and scream, chasing the \"tagger\" out of the hut.")
        }
        else {
          msg ("They just look like a bunch of annoying kids who are loud and contributing to your headache.  You really need to get rid of this headache so you can focus and figure out what to do next.")
        }
      ]]></watch>
    </object>
    <command name="watch game cmd">
      <pattern>watch children; watch game; watch kids; watch kids play game; watch children play game; watch children play; observe children playing; observe children playing game; observe kids; observe kid; watch kid play game; watch child play; observe game; watch; observe</pattern>
      <script><![CDATA[
        if (GetBoolean(Xanadu, "quenched")) {
          msg ("With a little settling of your stomach and clearing of the cobwebs, you watch the children play their game.  A few kids run in, sometimes one, sometimes two or three.  Shortly thereafter another kid enters and tries to tag one of the others.  But, the kid doesn't tag normally, but instead raises one hand up with two outstretched, curved fingers and pokes them down on one of the other kids.  Occassionally, before a kid gets poked, they will shout <b>\"Akhet! Akhet!\"</b> at which point the \"tagger\" races from the hut screaming while the other children laugh and follow.")
          SetObjectFlagOn (game1, "watched")
        }
        else if (GetBoolean(game1, "watched")) {
          msg ("The kids are still running around playing a game.  It's all nice and quiet until one kids shouts <b>\"Akhet!\"</b> just before getting tagged.  Then they all run and scream, chasing the \"tagger\" out of the hut.")
        }
        else {
          msg ("They just look like a bunch of annoying kids who are loud and contributing to your headache.  You really need to get rid of this headache so you can focus and figure out what to do next.")
        }
      ]]></script>
    </command>
    <object name="game1">
      <inherit name="editor_object" />
      <alias>game</alias>
      <scenery />
      <visible />
      <takemsg>You cannot take the game they are playing.</takemsg>
      <alt type="stringlist">
        <value>play</value>
      </alt>
      <look type="script"><![CDATA[
        if (GetBoolean(Xanadu, "quenched")) {
          msg ("With a little settling of your stomach and clearing of the cobwebs, you watch the children play their game.  A few kids run in, sometimes one, sometimes two or three.  Shortly thereafter another kid enters and tries to tag one of the others.  But, the kid doesn't tag normally, but instead raises one hand up with two outstretched, curved fingers and pokes them down on one of the other kids.  Occassionally, before a kid gets poked, they will shout <b>\"Akhet! Akhet!\"</b> at which point the \"tagger\" races from the hut screaming while the other children laugh and follow.")
        }
        else {
          msg ("They just look like a bunch of annoying kids who are loud and contributing to your headache.  You really need to get rid of this headache so you can focus and figure out what to do next.")
        }
      ]]></look>
    </object>
    <object name="Calista">
      <inherit name="editor_object" />
      <alt type="stringlist">
        <value>lady</value>
        <value>gal</value>
        <value>girl</value>
        <value>woman</value>
      </alt>
      <takemsg>She appears heavy.  She also would probably not enjoy being part of your inventory.  You leave her alone.</takemsg>
      <drop />
      <visible type="boolean">false</visible>
      <look type="script">
        if (GetBoolean(woman, "observed")) {
          msg ("Calista is wearing a colorful robe and is currently tending to the chickens.  Occassionally, she'll turn in your direction, smile, and nod.")
        }
        else {
          msg ("She is colorfully dressed in a long silky robe.  Currently, she facing away from you, busy working on something.  You can't tell what she is doing because she makes a better door than a window.  She is quiet but not eerily so.  From her occassional smile, she seems glad you are here.")
        }
      </look>
      <speak type="script"><![CDATA[
        firsttime {
          if (GetBoolean(Xanadu, "quenched")) {
            msg ("\"Did you enjoy your drink, sir?\" she asks while smiling at you.  \"Those there drinks will make you feel better.\"")
          }
          else {
            msg ("\"Are you thirsty, my little sand worm?\"<br/><br/>Come to think of it, you <i>are</i> pretty thirsty.")
          }
        }
        otherwise {
          if (GetBoolean(Xanadu, "quenched")) {
            msg ("\"Did you enjoy your drink, sir?\" she asks while smiling at you.  \"Those there drinks will make you feel better.\"")
          }
          else {
            msg ("She listens and her countenance suggests that she feels pity for you.  \"You do not look so good, sir.  Would like something to drink?  You should really get a drink.  I would be happy to make you one.\"  She smiles at you and adds, \"Just let me know, sir.")
          }
        }
      ]]></speak>
      <watch type="script">
        if (GetBoolean(woman, "observed")) {
          msg ("So far you've seen her slit the throats of a few chickens, pluck them, and hang them on the line.")
        }
        else {
          msg ("You cringe as you see the woman slit the throat of a live chicken.  She hangs it on a thin rope with a few other featherless birds.  She moves down the line to another headless chicken and begins plucking.  She must be getting ready for a meal.")
          SetObjectFlagOn (, "")
        }
      </watch>
      <observe type="script">
        if (GetBoolean(woman, "observed")) {
          msg ("So far you've seen her slit the throats of a few chickens, pluck them, and hang them on the line.")
        }
        else {
          msg ("You cringe as you see the woman slit the throat of a live chicken.  She hangs it on a thin rope with a few other featherless birds.  She moves down the line to another headless chicken and begins plucking.  She must be getting ready for a meal.")
          SetObjectFlagOn (woman, "observed")
        }
      </observe>
    </object>
    <object name="drink1">
      <inherit name="editor_object" />
      <alias>drink</alias>
      <visible type="boolean">false</visible>
      <look>It has the consistency of a milkshake, is lime green, and has an earthy odor.  According to the kind lady in the hut, it works wonders for your mind and body.</look>
      <take />
      <dropmsg>You keep a hold of it for fear of spilling it.</dropmsg>
      <takemsg>You pick it up.</takemsg>
      <drop type="boolean">false</drop>
      <drink type="script"><![CDATA[
        msg ("You look over at the friendly lady and she smiles and offers an encouraging nod.  You raise the concoction to your lips and tip it back.<br/><br/>*Gulp... gulp, gulp, gulp*<br/><br/>It goes down a lot easier than you expected.  Almost immediately you begin to feel a little better!<br/><br/>Calista smiles.  \"Good, yes?\"  She returns her attention to the chickens.")
        RemoveObject (drink1)
        SetObjectFlagOn (Xanadu, "quenched")
        MakeObjectVisible (coconut cup)
      ]]></drink>
    </object>
    <object name="coconut cup">
      <inherit name="editor_object" />
      <visible type="boolean">false</visible>
      <look>It's brown and fuzzy and hard.  It looks like a hollowed out half of a coconut only about half the size.</look>
      <take />
      <takemsg>You are carrying a small hollow nut... go figure.</takemsg>
      <dropmsg>Your nut finally dropped!</dropmsg>
    </object>
    <command name="ask drink cmd">
      <pattern>ask for drink; ask woman for drink; ask calista for drink; get drink; ask for water; ask for beverage; ask woman for water; ask woman for beverage; ask girl for beverage; ask calista for water; ask calista for beverage; ask calista for drink</pattern>
      <script><![CDATA[
        if (GetBoolean(Xanadu, "quenched")) {
          msg ("\"Ah.  You like, yes?\"  Calista smiles.  \"But, you should not drink another, sir.  Too many will make you sick.\"")
        }
        else {
          msg ("\"Yes, right away, good sir.\"  <br/><br/>Calista exits the hut and within a few moments she returns with a brown cup.  She walks over to the chickens and grabs a few items, grinds them up and sprinkles them in the cup.  She walks towards you and shoves the big drink into your hands.  \"Drink up, sir,\" she says with a smile.")
          AddToInventory (drink1)
          MakeObjectVisible (drink1)
        }
      ]]></script>
    </command>
    <exit alias="north" to="village outskirts">
      <inherit name="northdirection" />
      <lockmessage type="string"></lockmessage>
      <runscript />
      <script type="script">
        if (GetBoolean(Xanadu, "quenched")) {
          firsttime {
            msg ("With renewed strength you head out of the hut.")
            MoveObject (Xanadu, village outskirts)
          }
          otherwise {
            msg ("You walk out of the hut.")
            MoveObject (Xanadu, village outskirts)
          }
        }
        else {
          msg ("You are too weak to go walking around.  You'll need to regain some of your strength first.")
        }
      </script>
    </exit>
  </object>
  <command name="credit cmd">
    <pattern>credit; credits</pattern>
    <script><![CDATA[
      msg ("Credits:<br/><br/><u>Intro Music</u><br/>\"Club Diver\" Kevin MacLeod (incompetech.com)<br/>Licensed under Creative Commons: By Attribution 3.0 License<br/>http://creativecommons.org/licenses/by/3.0/<br/><br/><u>Layout</u><br/>Panes:  HaganeSteel<br/>Basic Layout:  OurJud, Jay (and others)")
    ]]></script>
  </command>
  <verb>
    <property>watch</property>
    <pattern>watch</pattern>
    <defaultexpression>"You can't watch " + object.article + "."</defaultexpression>
  </verb>
  <verb>
    <property>observe</property>
    <pattern>observe</pattern>
    <defaultexpression>"You can't observe " + object.article + "."</defaultexpression>
  </verb>
  <object name="village outskirts">
    <inherit name="editor_room" />
    <exit alias="south" to="hut">
      <inherit name="southdirection" />
    </exit>
  </object>
  <function name="ClearScreen">
    request (ClearScreen, "")
    OutputTextNoBr (game.css)
  </function>
  <function name="InitUserInterface"><![CDATA[
    JS.setCommandBarStyle (GetCurrentTextFormat("") + ";border:" + game.defaultbackground)
    JS.eval ("$('#status').hide();")
    JS.SetBackgroundCol ("black")
    JS.eval ("$('#txtCommandDiv').prepend('&gt;&nbsp;')")
    JS.OutputTextNoBr (game.css)
    JS.eval ("$('#statusVarsLabel').insertBefore('#inventoryLabel')")
    JS.eval ("$('#statusVarsAccordion').insertBefore('#inventoryLabel')")
    JS.eval ("$('#compassLabel').insertBefore('#inventoryLabel')")
    JS.eval ("$('#compassAccordion').insertBefore('#inventoryLabel')")
    JS.eval ("$('#placesObjectsLabel').insertBefore('#inventoryLabel')")
    JS.eval ("$('#placesObjectsAccordion').insertBefore('#inventoryLabel')")
    JS.eval ("$('#gamePanes').css('background-color', 'rgba(0, 0, 0, 0)')")
    JS.eval ("$('#statusVars').css('background-color', 'black')")
    JS.eval ("$('#statusVars').css('color', 'blue')")
    request (SetInterfaceString, "PlacesObjectsLabel=Objects")
    JS.eval ("$('#inventoryAccordion.ui-widget-content').css('background', 'black')")
    JS.eval ("$('#inventoryAccordion.ui-widget-content').css('color', 'blue')")
    JS.eval ("$('#statusVarsLabel').css('background', 'black')")
    JS.eval ("$('#statusVarsLabel').css('color', 'blue')")
    JS.eval ("$('#inventoryLabel').css('background', 'black')")
    JS.eval ("$('#inventoryLabel').css('color', 'blue')")
    JS.eval ("$('#placesObjectsLabel').css('background', 'black')")
    JS.eval ("$('#placesObjectsLabel').css('color', 'blue')")
    JS.eval ("$('#placesObjectsAccordion.ui-widget-content').css('background', 'black')")
    JS.eval ("$('#placesObjectsAccordion.ui-widget-content').css('color', 'blue')")
    JS.eval ("$('.ui-state-active').css('border', '1px solid darkgoldenrod')")
    JS.eval ("$('.ui-widget-content').css('border', 'blue')")
    JS.eval ("$('#gamePanesFinished').html('<h2></h2>')")
    JS.eval ("$('.ui-button').css('background', 'black')")
    JS.eval ("$('.ui-button').css('border', '1px blue')")
    JS.eval ("$('.ui-button-text').css('color', 'blue')")
    JS.eval ("$('.ui-button').mousedown(function() { $(this).css('background-color', 'blue'); } )")
    JS.eval ("$('.ui-button-text').mousedown(function() { $(this).css('color', 'black'); } )")
    JS.eval ("$('#gameBorder').mouseup(function() { $('.ui-button-text').css('color', 'blue'); } )")
    JS.eval ("$('#gameBorder').mouseup(function() { $('.ui-button').css('background-color', 'black'); } )")
    JS.eval ("var styleSelecting = $('<style>.ui-selecting { color: black; background-color: blue;}</style>');  $('html > head').append(styleSelecting)")
    JS.eval ("var styleUnselecting = $('<style>.ui-unselecting { color: blue; background-color: black;}</style>');  $('html > head').append(styleUnselecting)")
    JS.eval ("var styleSelected = $('<style>.ui-selected { color: black; background-color: blue;}</style>');  $('html > head').append(styleSelected)")
    JS.eval (" var arrowUrl = 'images/ui-icons_f9bd01_256x240.png'; var styleArrow = $('<style>.ui-state-default .ui-icon { background-image: url('+ arrowUrl +'); }</style>');  $('html > head').append(styleArrow) ")
    JS.eval ("$('#cmdCompassN').css('background', 'black')")
    JS.eval ("$('#cmdCompassE').css('background', 'black')")
    JS.eval ("$('#cmdCompassS').css('background', 'black')")
    JS.eval ("$('#cmdCompassW').css('background', 'black')")
    JS.eval ("$('#cmdCompassNW').css('background', 'black')")
    JS.eval ("$('#cmdCompassNE').css('background', 'black')")
    JS.eval ("$('#cmdCompassSW').css('background', 'black')")
    JS.eval ("$('#cmdCompassSE').css('background', 'black')")
    JS.eval ("$('#cmdCompassU').css('background', 'black')")
    JS.eval ("$('#cmdCompassIn').css('background', 'black')")
    JS.eval ("$('#cmdCompassD').css('background', 'black')")
    JS.eval ("$('#cmdCompassOut').css('background', 'black')")
    JS.eval ("$('#cmdCompassN').css('border', '2px solid blue')")
    JS.eval ("$('#cmdCompassE').css('border', '2px solid blue')")
    JS.eval ("$('#cmdCompassW').css('border', '2px solid blue')")
    JS.eval ("$('#cmdCompassS').css('border', '2px solid blue')")
    JS.eval ("$('#cmdCompassNW').css('border', '2px solid blue')")
    JS.eval ("$('#cmdCompassNE').css('border', '2px solid blue')")
    JS.eval ("$('#cmdCompassSE').css('border', '2px solid blue')")
    JS.eval ("$('#cmdCompassSW').css('border', '2px solid blue')")
    JS.eval ("$('#cmdCompassIn').css('border', '2px solid blue')")
    JS.eval ("$('#cmdCompassOut').css('border', '2px solid blue')")
    JS.eval ("$('#cmdCompassU').css('border', '2px solid blue')")
    JS.eval ("$('#cmdCompassD').css('border', '2px solid blue')")
    JS.eval ("$('#compassLabel').css('background', 'black')")
    JS.eval ("$('#compassLabel').css('color', 'blue')")
    JS.eval ("$('#compassAccordion').css('background', 'black')")
    OutputTextNoBr (game.css)
    request (SetInterfaceString, "TypeHereLabel=")
    if (GetBoolean(game, "inprogress")) {
    }
    else {
      game.inprogress = true
    }
  ]]></function>
  <function name="HideCommandBar">
    request (Hide, "Command")
  </function>
  <function name="ShowCommandBar">
    request (Show, "Command")
  </function>
</asl>